,Player,Nation,Pos,Squad.2,Age,Born,90s,Tkl,TklW,Def_3rd,Mid_3rd,Att_3rd,Tkl1,Att,Tkl%,Lost,Blocks,Sh,Pass,Int,Tkl+Int,Clr,Err
0,Patrick van Aanholt,nl NED,"MF,DF",PSV Eindhoven,32,1990,1.1,4,1,0,4,0,2,6,33.3,4,1,0,1,2,6,0,0
1,Brenden Aaronson,us USA,MF,Union Berlin,22,2000,1.5,1,0,1,0,0,0,4,0.0,4,5,1,4,3,4,1,0
2,Salis Abdul Samed,gh GHA,MF,Lens,23,2000,5.5,9,5,3,6,0,2,6,33.3,4,6,1,5,5,14,7,0
3,Francesco Acerbi,it ITA,DF,Inter,35,1988,4.7,3,1,2,0,1,2,5,40.0,3,1,0,1,5,8,15,0
4,Elias Achouri,tn TUN,"FW,MF",FC Copenhagen,24,1999,6.1,16,11,10,0,6,5,11,45.5,6,6,0,6,2,18,4,1
5,Marcos Acuña,ar ARG,DF,Sevilla,31,1991,2.2,2,2,1,1,0,1,2,50.0,1,1,1,0,1,3,2,0
6,Karim Adeyemi,de GER,FW,Dortmund,21,2002,7.9,7,5,4,3,0,4,8,50.0,4,7,0,7,8,15,5,0
7,Yacine Adli,fr FRA,MF,Milan,23,2000,1.4,3,2,1,2,0,2,4,50.0,2,0,0,0,3,6,4,0
8,Ruben Aguilar,fr FRA,DF,Lens,30,1993,1.1,4,4,2,2,0,2,3,66.7,1,3,0,3,0,4,1,0
9,Manuel Akanji,ch SUI,"DF,MF",Manchester City,28,1995,7.4,12,7,5,4,3,4,7,57.1,3,4,2,2,2,14,11,0
10,Nathan Aké,nl NED,"DF,MF",Manchester City,28,1995,4.3,4,2,3,1,0,2,3,66.7,1,1,0,1,0,4,11,0
11,Kerem Aktürkoğlu,tr TUR,"MF,FW",Galatasaray,24,1998,4.9,5,4,1,2,2,5,7,71.4,2,3,0,3,2,7,5,0
12,David Alaba,at AUT,DF,Real Madrid,31,1992,2.8,1,1,0,1,0,1,1,100.0,0,1,1,0,3,4,9,1
13,Luis Alberto,es ESP,MF,Lazio,30,1992,7.1,4,2,1,2,1,1,10,10.0,9,13,4,9,7,11,3,0
14,Toby Alderweireld,be BEL,DF,Antwerp,34,1989,5.0,6,4,4,2,0,5,9,55.6,4,9,5,4,5,11,24,0
15,Mohamed Ali Cho,fr FRA,"FW,MF",Real Sociedad,19,2004,1.5,0,0,0,0,0,0,0,0.0,0,1,0,1,0,0,0,0
16,Miguel Almirón,py PAR,FW,Newcastle Utd,29,1994,4.6,15,11,4,7,4,10,15,66.7,5,8,1,7,4,19,2,0
17,Marcos Alonso,es ESP,"DF,FW",Barcelona,32,1990,1.5,1,0,0,1,0,1,1,100.0,0,3,0,3,2,3,5,0
18,Barış Alper Yılmaz,tr TUR,"FW,MF",Galatasaray,23,2000,1.4,2,2,0,1,1,0,4,0.0,4,0,0,0,2,4,0,0
19,Julián Álvarez,ar ARG,"MF,FW",Manchester City,23,2000,3.1,3,2,0,2,1,2,5,40.0,3,1,1,0,0,3,2,0
20,Mohamed Aly Camara,gn GUI,DF,Young Boys,25,1997,5.0,8,4,6,2,0,3,6,50.0,3,12,9,3,6,14,24,0
21,Aurele Amenda,ch SUI,DF,Young Boys,20,2003,3.5,7,4,4,3,0,3,9,33.3,6,5,1,4,6,13,10,0
22,Sofyan Amrabat,ma MAR,"MF,DF",Manchester Utd,26,1996,3.6,8,5,5,2,1,6,8,75.0,2,10,1,9,3,11,3,0
23,Elliot Anderson,eng ENG,MF,Newcastle Utd,20,2002,0.5,2,1,1,1,0,0,2,0.0,2,1,1,0,2,4,0,0
24,Felipe Anderson,br BRA,FW,Lazio,30,1993,6.0,17,7,5,10,2,5,21,23.8,16,7,0,7,12,29,5,0
26,Angeliño,es ESP,DF,Galatasaray,26,1997,4.7,7,5,3,2,2,4,9,44.4,5,6,3,3,6,13,9,0
27,Peter Ankersen,dk DEN,DF,FC Copenhagen,32,1990,5.2,12,8,7,4,1,8,17,47.1,9,5,4,1,10,22,11,0
28,Antony,br BRA,FW,Manchester Utd,23,2000,2.6,7,6,5,1,1,5,9,55.6,4,5,1,4,5,12,2,0
29,Jon Aramburu,ve VEN,DF,Real Sociedad,21,2002,0.0,0,0,0,0,0,0,0,0.0,0,0,0,0,0,0,1,0
30,Ronald Araújo,uy URU,DF,Barcelona,24,1999,7.3,12,10,4,7,1,4,5,80.0,1,14,10,4,8,20,20,0
31,Tomás Araújo,pt POR,DF,Benfica,21,2002,1.8,3,2,1,2,0,1,1,100.0,0,5,4,1,4,7,5,0
32,Marko Arnautović,at AUT,FW,Inter,34,1989,2.1,0,0,0,0,0,0,0,0.0,0,1,0,1,1,1,2,0
33,Kepa Arrizabalaga,es ESP,GK,Real Madrid,28,1994,4.0,0,0,0,0,0,0,0,0.0,0,0,0,0,0,0,0,0
34,Marco Asensio,es ESP,"FW,MF",Paris S-G,27,1996,1.4,2,1,2,0,0,0,1,0.0,1,2,2,0,0,2,0,0
35,Kristjan Asllani,al ALB,MF,Inter,21,2002,2.3,2,1,1,1,0,0,2,0.0,2,3,1,2,1,3,3,0
36,Otavio Ataide,br BRA,DF,Porto,21,2002,2.3,4,4,3,1,0,1,1,100.0,0,3,3,0,0,4,6,0
37,Emil Audero,id IDN,GK,Inter,26,1997,1.0,0,0,0,0,0,0,0,0.0,0,0,0,0,0,0,0,0
38,Carlos Augusto,br BRA,"DF,FW",Inter,24,1999,5.3,10,6,6,4,0,5,10,50.0,5,6,2,4,0,10,15,0
39,Yann Aurel Bisseck,de GER,DF,Inter,22,2000,1.9,1,0,1,0,0,0,1,0.0,1,3,2,1,1,2,8,0
40,Fredrik Aursnes,no NOR,"DF,MF",Benfica,27,1995,6.0,13,8,8,4,1,7,13,53.8,6,9,2,7,3,16,13,0
41,Kaan Ayhan,tr TUR,"MF,DF",Galatasaray,28,1994,4.2,8,5,2,5,1,3,9,33.3,6,3,2,1,11,19,8,0
42,Neil El Aynaoui,fr FRA,MF,Lens,22,2001,1.5,5,2,2,2,1,2,2,100.0,0,2,1,1,1,6,4,0
43,Irakli Azarov,ge GEO,DF,Shakhtar,21,2002,3.3,9,5,6,3,0,3,13,23.1,10,2,1,1,4,13,12,0
44,César Azpilicueta,es ESP,DF,Atlético Madrid,33,1989,3.2,6,5,3,2,1,2,6,33.3,4,11,5,6,5,11,13,0
45,Isaac Babadi,nl NED,"FW,MF",PSV Eindhoven,18,2005,0.2,1,1,1,0,0,0,0,0.0,0,1,0,1,0,1,0,1
46,Loïc Bade,fr FRA,DF,Sevilla,23,2000,1.1,4,3,4,0,0,4,4,100.0,0,1,1,0,1,5,7,0
47,Alexander Bah,dk DEN,DF,Benfica,25,1997,2.1,11,6,7,3,1,7,9,77.8,2,7,1,6,4,15,6,0
48,Samson Baidoo,at AUT,DF,RB Salzburg,19,2004,3.4,9,5,6,3,0,5,10,50.0,5,6,3,3,0,9,12,0
49,Cédric Bakambu,cd COD,FW,Galatasaray,32,1991,0.4,0,0,0,0,0,0,0,0.0,0,0,0,0,0,0,0,0
50,Johan Bakayoko,be BEL,FW,PSV Eindhoven,20,2003,7.2,10,8,4,4,2,6,9,66.7,3,8,1,7,4,14,3,0
52,Alejandro Balde,es ESP,DF,Barcelona,19,2003,3.7,6,4,2,2,2,4,5,80.0,1,3,0,3,1,7,5,0
53,Michel-Ange Balikwisha,be BEL,"FW,MF",Antwerp,22,2001,4.3,9,4,1,7,1,3,8,37.5,5,5,0,5,5,14,1,0
54,David von Ballmoos,ch SUI,GK,Young Boys,28,1994,1.0,0,0,0,0,0,0,0,0.0,0,0,0,0,0,0,1,0
55,Simon Banza,cd COD,FW,Braga,26,1996,3.8,1,0,0,1,0,0,0,0.0,0,3,0,3,0,1,2,0
56,Bradley Barcola,fr FRA,"FW,DF",Paris S-G,20,2002,5.3,12,10,4,5,3,3,16,18.8,13,9,0,9,3,15,3,0
57,Abdülkerim Bardakcı,tr TUR,DF,Galatasaray,28,1994,6.0,19,9,13,4,2,13,19,68.4,6,6,5,1,11,30,25,0
58,Roony Bardghji,se SWE,"MF,FW",FC Copenhagen,17,2005,1.6,0,0,0,0,0,0,3,0.0,3,0,0,0,1,1,1,0
59,Nicolò Barella,it ITA,MF,Inter,26,1997,5.2,16,13,6,7,3,5,10,50.0,5,6,2,4,5,21,5,0
60,Harvey Barnes,eng ENG,FW,Newcastle Utd,25,1997,0.0,0,0,0,0,0,0,0,0.0,0,0,0,0,0,0,0,0
61,Romário Baró,pt POR,MF,Porto,23,2000,0.7,0,0,0,0,0,0,1,0.0,1,1,0,1,1,1,1,1
62,Ander Barrenetxea,es ESP,"FW,MF",Real Sociedad,21,2001,4.4,12,6,7,2,3,7,14,50.0,7,3,0,3,1,13,2,0
63,Pablo Barrios,es ESP,MF,Atlético Madrid,20,2003,2.9,5,5,4,1,0,2,6,33.3,4,4,3,1,7,12,4,0
64,Davide Bartesaghi,it ITA,FW,Milan,17,2005,0.0,0,0,0,0,0,0,1,0.0,1,0,0,0,0,0,0,0
65,Alessandro Bastoni,it ITA,DF,Inter,24,1999,5.6,5,1,3,2,0,1,3,33.3,2,6,1,5,6,11,15,1
66,Jelle Bataille,be BEL,DF,Antwerp,24,1999,4.6,9,6,6,1,2,7,12,58.3,5,3,0,3,5,14,2,0
67,Christoph Baumgartner,at AUT,MF,RB Leipzig,23,1999,1.3,3,1,2,0,1,2,5,40.0,3,2,0,2,3,6,3,0
68,Sheraldo Becker,sr SUR,FW,Union Berlin,28,1995,4.1,0,0,0,0,0,0,0,0.0,0,3,1,2,1,1,1,0
69,Sheraldo Becker,sr SUR,FW,Real Sociedad,28,1995,0.7,0,0,0,0,0,0,0,0.0,0,0,0,0,0,0,0,0
70,Thomas Beelen,nl NED,DF,Feyenoord,22,2001,0.9,2,1,1,1,0,1,1,100.0,0,0,0,0,0,2,2,0
71,Kevin Behrens,de GER,FW,Union Berlin,32,1991,3.3,3,2,0,2,1,1,2,50.0,1,4,2,2,1,4,9,0
72,Armel Bella Kotchap,de GER,DF,PSV Eindhoven,21,2001,0.9,3,2,3,0,0,3,4,75.0,1,2,2,0,0,3,1,0
73,Jude Bellingham,eng ENG,"MF,FW",Real Madrid,20,2003,11.0,20,9,8,7,5,5,12,41.7,7,7,2,5,7,27,7,0
74,Walter Benítez,ar ARG,GK,PSV Eindhoven,30,1993,8.0,0,0,0,0,0,0,0,0.0,0,0,0,0,0,0,2,0
75,Loris Benito,ch SUI,DF,Young Boys,31,1992,4.5,6,4,3,3,0,3,8,37.5,5,7,5,2,7,13,15,0
76,Ramy Bensebaini,dz ALG,DF,Dortmund,28,1995,4.2,21,12,12,7,2,12,15,80.0,3,16,6,10,7,28,9,0
78,Lucas Beraldo,br BRA,DF,Paris S-G,19,2003,4.5,11,7,7,4,0,6,13,46.2,7,4,2,2,5,16,13,0
79,Paulo Bernardo,pt POR,MF,Celtic,21,2002,3.5,2,0,2,0,0,0,7,0.0,7,8,2,6,5,7,2,0
80,Juan Bernat,es ESP,DF,Benfica,30,1993,1.2,3,2,1,2,0,3,3,100.0,0,1,1,0,1,4,1,0
81,Mads Bidstrup,dk DEN,MF,RB Salzburg,22,2001,5.5,22,15,12,8,2,9,18,50.0,9,22,4,18,7,29,16,0
82,Justin Bijlow,nl NED,GK,Feyenoord,25,1998,4.0,0,0,0,0,0,0,1,0.0,1,1,0,1,0,0,3,0
83,Janis Blaswich,de GER,GK,RB Leipzig,32,1991,5.0,0,0,0,0,0,0,0,0.0,0,0,0,0,0,0,2,0
84,Lewin Blum,ch SUI,DF,Young Boys,22,2001,2.4,5,5,4,0,1,4,7,57.1,3,2,1,1,2,7,6,0
85,Oscar Bobb,no NOR,"FW,MF",Manchester City,20,2003,2.4,2,1,0,2,0,2,2,100.0,0,0,0,0,0,2,0,0
86,Sacha Boey,fr FRA,DF,Galatasaray,22,2000,6.0,20,12,13,5,2,11,22,50.0,11,10,3,7,6,26,20,0
87,Nicolai Boilesen,dk DEN,"DF,FW",FC Copenhagen,31,1992,1.0,1,1,1,0,0,1,2,50.0,1,2,1,1,0,1,5,0
88,Valerii Bondar,ua UKR,DF,Shakhtar,24,1999,4.0,7,4,4,3,0,5,7,71.4,2,6,3,3,5,12,18,2
89,Artem Bondarenko,ua UKR,MF,Shakhtar,22,2000,2.5,4,4,2,2,0,2,4,50.0,2,6,1,5,2,6,4,0
90,Leonardo Bonucci,it ITA,DF,Union Berlin,36,1987,2.9,1,0,1,0,0,1,2,50.0,1,5,5,0,2,3,23,0
91,Gonçalo Borges,pt POR,FW,Porto,22,2001,0.4,1,1,0,1,0,0,0,0.0,0,0,0,0,1,2,0,0
92,Cristian Borja,co COL,DF,Braga,30,1993,5.7,13,7,6,6,1,6,8,75.0,2,10,0,10,3,16,11,0
93,Olivier Boscagli,fr FRA,DF,PSV Eindhoven,25,1997,6.8,15,7,9,5,1,6,10,60.0,4,10,5,5,11,26,26,0
94,Sven Botman,nl NED,DF,Newcastle Utd,23,2000,1.0,0,0,0,0,0,0,1,0.0,1,1,1,0,0,0,2,0
95,Julian Brandt,de GER,"MF,FW",Dortmund,27,1996,8.7,17,9,7,9,1,14,22,63.6,8,10,0,10,4,21,10,0
96,Bruma,pt POR,FW,Braga,28,1994,4.1,8,4,3,3,2,4,7,57.1,3,3,0,3,1,9,2,0
97,Osman Bukari,gh GHA,FW,Red Star,24,1998,5.4,5,3,1,1,3,2,4,50.0,2,2,0,2,2,7,2,0
98,Dan Burn,eng ENG,DF,Newcastle Utd,31,1992,3.1,6,3,5,1,0,3,4,75.0,1,9,5,4,1,7,16,0
99,Jean Butez,fr FRA,GK,Antwerp,28,1995,5.0,0,0,0,0,0,0,2,0.0,2,0,0,0,0,0,0,2
100,Arthur Cabral,br BRA,"FW,DF",Benfica,25,1998,1.3,3,2,1,2,0,1,1,100.0,0,0,0,0,0,3,2,0
101,Jens Cajuste,se SWE,MF,Napoli,23,1999,1.8,7,4,5,2,0,4,6,66.7,2,3,1,2,2,9,2,0
102,Davide Calabria,it ITA,DF,Milan,26,1996,4.8,18,14,10,3,5,11,18,61.1,7,8,2,6,3,21,10,0
104,Hakan Çalhanoğlu,tr TUR,MF,Inter,29,1994,5.7,10,5,7,2,1,4,13,30.8,9,8,2,6,6,16,4,0
105,Eduardo Camavinga,fr FRA,MF,Real Madrid,20,2002,8.8,25,13,13,6,6,10,20,50.0,10,21,6,15,9,34,20,0
106,Emre Can,de GER,"MF,DF",Dortmund,29,1994,10.1,19,12,10,8,1,11,22,50.0,11,13,3,10,12,31,14,0
107,João Cancelo,pt POR,DF,Barcelona,29,1994,9.0,32,22,16,11,5,21,28,75.0,7,13,6,7,19,51,17,1
108,Nicolás Capaldo,ar ARG,"MF,DF",RB Salzburg,25,1997,2.4,9,3,6,3,0,4,9,44.4,5,4,0,4,6,15,3,0
109,Fábio Cardoso,pt POR,DF,Porto,29,1994,3.0,2,2,0,1,1,0,1,0.0,1,3,2,1,3,5,5,0
110,David Carmo,ao ANG,DF,Porto,24,1999,4.0,5,2,4,1,0,2,3,66.7,1,7,5,2,4,9,20,0
111,Cameron Carter-Vickers,us USA,DF,Celtic,25,1997,3.3,4,2,2,2,0,3,4,75.0,1,4,2,2,4,8,12,0
112,Dani Carvajal,es ESP,DF,Real Madrid,31,1992,9.4,24,13,13,11,0,11,18,61.1,7,17,7,10,9,33,27,0
113,Fabio Carvalho,pt POR,MF,RB Leipzig,20,2002,1.4,6,2,2,1,3,3,10,30.0,7,3,0,3,1,7,0,0
114,Vitor Carvalho,br BRA,MF,Braga,26,1997,2.9,4,3,2,2,0,3,5,60.0,2,5,2,3,1,5,6,0
115,Marc Casado,es ESP,MF,Barcelona,19,2003,0.3,0,0,0,0,0,0,0,0.0,0,2,1,1,1,1,1,0
116,Nicolò Casale,it ITA,DF,Lazio,25,1998,2.0,1,1,1,0,0,0,2,0.0,2,1,0,1,0,1,9,0
117,Casemiro,br BRA,MF,Manchester Utd,31,1992,1.8,6,3,4,2,0,3,9,33.3,6,3,0,3,1,7,4,0
118,Valentín Castellanos,ar ARG,FW,Lazio,24,1998,2.4,2,0,1,1,0,0,5,0.0,5,1,0,1,0,2,2,0
119,André Castro,pt POR,MF,Braga,35,1988,0.1,0,0,0,0,0,0,0,0.0,0,0,0,0,0,0,0,0
120,Danilo Cataldi,it ITA,MF,Lazio,28,1994,1.8,2,1,1,1,0,1,2,50.0,1,0,0,0,1,3,1,0
121,Dani Ceballos,es ESP,MF,Real Madrid,26,1996,1.7,3,1,1,1,1,1,4,25.0,3,1,0,1,3,6,2,0
122,Miguel Chaiwa,zm ZAM,MF,Young Boys,19,2004,0.7,1,1,0,1,0,0,7,0.0,7,5,2,3,1,2,1,0
123,Chiquinho,pt POR,MF,Benfica,28,1995,0.6,1,1,0,1,0,0,0,0.0,0,1,1,0,0,1,2,0
124,Andreas Christensen,dk DEN,"DF,MF",Barcelona,27,1996,4.9,11,7,5,5,1,5,7,71.4,2,3,1,2,7,18,11,0
125,Samuel Chukwueze,ng NGA,FW,Milan,24,1999,1.8,2,2,0,1,1,1,3,33.3,2,2,1,1,0,2,1,0
126,Viktor Claesson,se SWE,"FW,MF",FC Copenhagen,31,1992,5.3,7,4,4,1,2,6,11,54.5,5,17,3,14,4,11,10,0
127,William Clem,dk DEN,MF,FC Copenhagen,19,2004,0.8,1,0,1,0,0,0,3,0.0,3,0,0,0,0,1,2,0
128,Ebrima Colley,gm GAM,"MF,FW",Young Boys,23,2000,1.4,3,2,1,2,0,1,4,25.0,3,2,0,2,1,4,0,0
130,Kingsley Coman,fr FRA,FW,Bayern Munich,27,1996,5.0,4,2,2,2,0,0,4,0.0,4,6,0,6,0,4,1,0
131,Francisco Conceição,pt POR,"FW,MF",Porto,20,2002,2.7,2,1,1,0,1,0,5,0.0,5,3,0,3,1,3,1,0
132,Kobe Corbanie,be BEL,"DF,FW",Antwerp,18,2005,0.4,1,0,0,1,0,0,0,0.0,0,0,0,0,1,2,4,0
133,Andreas Cornelius,dk DEN,"FW,MF",FC Copenhagen,30,1993,0.9,1,1,0,1,0,0,0,0.0,0,0,0,0,0,1,0,0
134,Ángel Correa,ar ARG,"FW,MF",Atlético Madrid,28,1995,3.6,1,1,0,1,0,0,1,0.0,1,3,0,3,0,1,4,0
135,David Costa,pt POR,"MF,FW",Lens,22,2001,1.3,2,2,0,1,1,2,2,100.0,0,1,0,1,2,4,0,0
136,Diogo Costa,pt POR,GK,Porto,23,1999,8.3,0,0,0,0,0,0,0,0.0,0,0,0,0,0,0,6,1
137,Soumaïla Coulibaly,fr FRA,DF,Antwerp,19,2003,6.0,5,3,5,0,0,3,4,75.0,1,8,7,1,7,12,26,0
138,Thibaut Courtois,be BEL,GK,Real Madrid,31,1992,1.0,0,0,0,0,0,0,1,0.0,1,0,0,0,0,0,0,0
139,Juan Cuadrado,co COL,"DF,FW",Inter,35,1988,1.3,0,0,0,0,0,0,0,0.0,0,1,0,1,1,1,1,0
140,Pau Cubarsí,es ESP,DF,Barcelona,16,2007,3.0,6,5,5,1,0,1,1,100.0,0,2,1,1,1,7,13,0
141,Diogo Dalot,pt POR,DF,Manchester Utd,24,1999,5.1,7,5,4,2,1,3,8,37.5,5,8,4,4,3,10,13,0
142,Kevin Danso,at AUT,DF,Lens,24,1998,6.0,4,2,3,1,0,3,5,60.0,2,4,2,2,4,8,27,0
143,Matteo Darmian,it ITA,"DF,FW",Inter,33,1989,4.5,8,3,3,4,1,5,9,55.6,4,9,2,7,2,10,10,0
144,David Datro Fofana,ci CIV,FW,Union Berlin,20,2002,2.2,2,1,0,1,1,1,1,100.0,0,1,0,1,0,2,6,0
145,Alphonso Davies,ca CAN,DF,Bayern Munich,22,2000,7.8,14,9,10,2,2,8,17,47.1,9,11,3,8,5,19,14,0
146,Kevin De Bruyne,be BEL,MF,Manchester City,32,1991,2.2,4,3,0,2,2,3,6,50.0,3,2,0,2,0,4,0,0
147,Ritchie De Laet,be BEL,DF,Antwerp,34,1988,2.5,4,2,3,1,0,2,5,40.0,3,5,3,2,3,7,11,0
148,Rodrigo De Paul,ar ARG,MF,Atlético Madrid,29,1994,6.8,10,4,3,6,1,6,11,54.5,5,16,0,16,4,14,7,1
149,Amar Dedić,ba BIH,DF,RB Salzburg,20,2002,6.0,12,4,9,1,2,7,13,53.8,6,10,2,8,6,18,21,0
150,Miloš Degenek,au AUS,FW,Red Star,29,1994,0.1,0,0,0,0,0,0,0,0.0,0,0,0,0,0,0,1,0
151,Ousmane Dembélé,fr FRA,"FW,MF",Paris S-G,26,1997,10.6,15,10,3,7,5,6,15,40.0,9,6,0,6,6,21,1,0
152,Kerem Demirbay,de GER,MF,Galatasaray,30,1993,0.7,2,1,1,0,1,2,4,50.0,2,0,0,0,0,2,0,0
153,Thomas van den Belt,nl NED,MF,Feyenoord,22,2001,0.4,1,0,0,1,0,0,1,0.0,1,0,0,0,1,2,0,0
154,Sergiño Dest,us USA,DF,PSV Eindhoven,22,2000,7.2,13,7,6,5,2,9,14,64.3,5,9,0,9,4,17,11,0
156,Giovanni Di Lorenzo,it ITA,DF,Napoli,29,1993,8.0,20,12,13,7,0,15,21,71.4,6,11,2,9,6,26,15,0
157,Ángel Di María,ar ARG,FW,Benfica,35,1988,4.6,3,3,2,1,0,1,7,14.3,6,4,0,4,1,4,2,0
158,Rúben Dias,pt POR,DF,Manchester City,26,1997,8.5,11,8,4,6,1,7,11,63.6,4,8,4,4,9,20,20,0
159,Brahim Díaz,ma MAR,"MF,FW",Real Madrid,23,1999,3.6,8,4,2,4,2,1,2,50.0,1,1,1,0,0,8,0,0
160,Eric Dier,eng ENG,DF,Bayern Munich,29,1994,5.0,7,5,4,2,1,3,3,100.0,0,6,4,2,6,13,18,0
161,Kevin Diks,id IDN,DF,FC Copenhagen,26,1996,7.9,8,5,8,0,0,6,6,100.0,0,8,5,3,7,15,39,0
162,Javairô Dilrosun,nl NED,DF,Feyenoord,25,1998,0.1,0,0,0,0,0,0,0,0.0,0,0,0,0,0,0,0,0
163,Federico Dimarco,it ITA,DF,Inter,25,1997,4.0,0,0,0,0,0,0,5,0.0,5,6,1,5,3,3,4,0
164,Andy Diouf,fr FRA,MF,Lens,20,2003,0.4,1,1,1,0,0,1,1,100.0,0,1,0,1,0,1,1,0
165,Novatus Dismas,tz TAN,DF,Shakhtar,20,2002,1.0,1,0,1,0,0,0,2,0.0,2,0,0,0,3,4,2,0
166,Álvaro djaló,es ESP,FW,Braga,23,1999,4.5,7,7,1,3,3,0,5,0.0,5,1,0,1,3,10,2,0
167,Nasser Djiga,bf BFA,DF,Red Star,20,2002,6.0,8,4,7,1,0,7,9,77.8,2,8,6,2,12,20,25,1
168,Marko Dmitrović,rs SRB,GK,Sevilla,31,1992,4.0,0,0,0,0,0,0,0,0.0,0,0,0,0,0,0,3,0
169,Danilho Doekhi,nl NED,DF,Union Berlin,25,1998,2.9,5,2,4,1,0,2,7,28.6,5,4,2,2,1,6,11,0
170,Jeremy Doku,be BEL,"FW,MF",Manchester City,21,2002,3.4,6,3,0,5,1,3,4,75.0,1,5,0,5,0,6,0,0
171,Gianluigi Donnarumma,it ITA,GK,Paris S-G,24,1999,12.0,1,1,1,0,0,1,1,100.0,0,0,0,0,0,1,7,3
172,Nene Dorgeles,ml MLI,"FW,MF",RB Salzburg,20,2002,1.5,3,2,0,2,1,1,1,100.0,0,4,0,4,1,4,0,0
173,Aleksandar Dragović,at AUT,DF,Red Star,32,1991,6.0,6,2,3,3,0,3,8,37.5,5,17,15,2,6,12,34,0
174,Martin Dúbravka,sk SVK,GK,Newcastle Utd,34,1989,1.0,0,0,0,0,0,0,0,0.0,0,0,0,0,0,0,0,0
175,Denzel Dumfries,nl NED,DF,Inter,27,1996,3.6,3,2,1,2,0,1,1,100.0,0,4,1,3,0,3,3,0
176,Ederson,br BRA,GK,Manchester City,29,1993,7.3,0,0,0,0,0,0,0,0.0,0,0,0,0,0,0,1,1
177,Jorge Eduardo Sánchez,mx MEX,DF,Porto,25,1997,2.1,7,4,4,1,2,4,8,50.0,4,0,0,0,1,8,5,0
178,Eguinaldo,br BRA,"MF,FW",Shakhtar,18,2004,0.2,1,1,0,1,0,0,1,0.0,1,0,0,0,0,1,0,0
179,Chidera Ejuke,ng NGA,FW,Antwerp,25,1998,1.7,2,1,1,1,0,2,4,50.0,2,2,0,2,3,5,0,0
180,Jurgen Ekkelenkamp,nl NED,MF,Antwerp,23,2000,3.0,0,0,0,0,0,0,4,0.0,4,5,0,5,1,1,3,0
182,Meschak Elia,cd COD,"FW,MF",Young Boys,25,1997,5.5,4,2,2,2,0,1,6,16.7,5,8,0,8,0,4,2,0
183,Elif Elmas,mk MKD,MF,RB Leipzig,23,1999,0.2,1,0,1,0,0,0,0,0.0,0,0,0,0,1,2,0,0
184,Elif Elmas,mk MKD,"FW,MF",Napoli,23,1999,1.6,0,0,0,0,0,0,1,0.0,1,2,0,2,2,2,0,0
185,Mohamed Elneny,eg EGY,MF,Arsenal,31,1992,0.7,0,0,0,0,0,0,1,0.0,1,1,0,1,0,0,0,0
186,Aritz Elustondo,es ESP,DF,Real Sociedad,29,1994,1.9,7,4,5,1,1,5,6,83.3,1,3,0,3,1,8,7,0
187,Mohamed Elyounoussi,no NOR,"FW,MF",FC Copenhagen,28,1994,7.6,20,9,14,4,2,9,20,45.0,11,10,2,8,11,31,7,1
188,Youssef En-Nesyri,ma MAR,FW,Sevilla,26,1997,5.7,5,2,2,2,1,2,2,100.0,0,4,1,3,3,8,2,0
189,Luis Enrique Palma,hn HON,FW,Celtic,23,2000,3.0,5,3,0,3,2,2,7,28.6,5,5,0,5,3,8,1,0
190,Christian Eriksen,dk DEN,MF,Manchester Utd,31,1992,2.3,0,0,0,0,0,0,3,0.0,3,3,1,2,3,3,3,0
191,Stephen Eustáquio,ca CAN,MF,Porto,26,1996,5.9,14,5,4,8,2,4,14,28.6,10,13,4,9,10,24,6,0
192,Evanilson,br BRA,FW,Porto,23,1999,5.4,6,3,1,4,1,3,4,75.0,1,3,0,3,3,9,2,0
193,Jonny Evans,nir NIR,DF,Manchester Utd,35,1988,0.7,1,1,1,0,0,1,1,100.0,0,2,1,1,0,1,1,0
194,Rasmus Falk,dk DEN,MF,FC Copenhagen,31,1992,7.0,19,8,11,5,3,14,20,70.0,6,8,2,6,9,28,9,1
195,João Félix,pt POR,FW,Barcelona,23,1999,4.1,4,1,0,3,1,0,6,0.0,6,0,0,0,0,4,1,0
196,Bruno Fernandes,pt POR,"MF,FW",Manchester Utd,28,1994,6.0,13,6,6,6,1,5,19,26.3,14,7,1,6,3,16,9,0
197,Roger Fernandes,pt POR,FW,Braga,17,2005,0.1,0,0,0,0,0,0,0,0.0,0,0,0,0,1,1,0,0
198,Carlos Fernández,es ESP,FW,Real Sociedad,27,1996,0.8,1,1,1,0,0,1,2,50.0,1,1,0,1,1,2,1,0
199,Fernando,br BRA,FW,RB Salzburg,24,1999,0.4,0,0,0,0,0,0,1,0.0,1,0,0,0,0,0,0,0
200,Fernando,br BRA,MF,Sevilla,36,1987,3.6,13,8,8,5,0,7,11,63.6,4,6,3,3,4,17,8,0
201,Alessandro Florenzi,it ITA,DF,Milan,32,1991,1.8,8,7,6,2,0,4,7,57.1,3,3,1,2,2,10,6,0
202,Phil Foden,eng ENG,"FW,MF",Manchester City,23,2000,7.6,1,1,0,0,1,0,2,0.0,2,5,0,5,2,3,3,0
203,Diogo Fonseca,pt POR,DF,Braga,21,2002,0.2,0,0,0,0,0,0,0,0.0,0,0,0,0,0,0,0,0
204,José Fonte,pt POR,DF,Braga,39,1983,4.0,4,1,3,1,0,1,6,16.7,5,6,4,2,1,5,16,1
205,James Forrest,sct SCO,FW,Celtic,32,1991,1.0,2,0,0,1,1,1,1,100.0,0,0,0,0,0,2,0,0
206,Emil Forsberg,se SWE,"MF,FW",RB Leipzig,31,1991,4.5,8,4,4,1,3,3,8,37.5,5,4,1,3,4,12,2,0
208,Amankwah Forson,gh GHA,"MF,FW",RB Salzburg,20,2002,0.8,3,2,3,0,0,1,2,50.0,1,3,1,2,0,3,0,0
209,Héctor Fort,es ESP,DF,Barcelona,16,2006,0.7,0,0,0,0,0,0,3,0.0,3,0,0,0,0,0,4,0
210,Mitchel Frame,sct SCO,FW,Celtic,17,2006,0.2,2,1,1,1,0,0,0,0.0,0,0,0,0,0,2,0,0
211,André Franco,pt POR,"MF,FW",Porto,25,1998,2.6,5,3,3,1,1,2,5,40.0,3,2,0,2,1,6,7,0
212,Przemysław Frankowski,pl POL,DF,Lens,28,1995,5.9,20,16,9,10,1,10,20,50.0,10,2,0,2,6,26,13,0
213,Davide Frattesi,it ITA,MF,Inter,23,1999,5.0,10,7,5,5,0,4,11,36.4,7,4,1,3,3,13,8,0
214,Victor Froholdt,dk DEN,MF,FC Copenhagen,17,2006,0.6,2,2,0,2,0,0,2,0.0,2,2,0,2,3,5,1,0
215,Angelo Fulgini,fr FRA,MF,Lens,26,1996,3.2,6,3,2,3,1,5,9,55.6,4,2,0,2,1,7,1,0
216,Niclas Füllkrug,de GER,FW,Dortmund,30,1993,11.5,2,1,0,2,0,0,3,0.0,3,10,1,9,1,3,10,0
217,Kyogo Furuhashi,jp JPN,FW,Celtic,28,1995,5.0,0,0,0,0,0,0,1,0.0,1,3,0,3,1,1,3,0
218,Gianluca Gaetano,it ITA,MF,Napoli,23,2000,0.2,0,0,0,0,0,0,1,0.0,1,1,0,1,0,0,0,0
219,Javi Galán,es ESP,DF,Atlético Madrid,28,1994,0.8,3,2,3,0,0,1,3,33.3,2,3,0,3,4,7,3,0
220,Javi Galán,es ESP,DF,Real Sociedad,28,1994,2.0,6,4,2,3,1,2,6,33.3,4,5,1,4,6,12,0,0
221,Galeno,br BRA,"MF,FW",Porto,25,1997,7.2,7,5,4,1,2,3,5,60.0,2,4,0,4,8,15,7,0
222,Silvère Ganvoula M'Boussy,cg CGO,FW,Young Boys,27,1996,1.3,0,0,0,0,0,0,0,0.0,0,1,0,1,0,0,3,0
223,Fran Garcia,es ESP,DF,Real Madrid,23,1999,2.1,1,1,1,0,0,1,4,25.0,3,1,0,1,1,2,6,0
224,Ulisses Garcia,ch SUI,DF,Young Boys,27,1996,5.6,14,9,10,2,2,7,15,46.7,8,11,2,9,4,18,7,0
225,Alejandro Garnacho,ar ARG,"FW,MF",Manchester Utd,19,2004,3.3,4,4,0,4,0,2,4,50.0,2,6,0,6,5,9,0,0
226,Gavi,es ESP,MF,Barcelona,18,2004,2.5,3,2,2,1,0,1,4,25.0,3,2,0,2,1,4,5,0
227,Lutsharel Geertruida,nl NED,DF,Feyenoord,23,2000,6.0,14,9,12,1,1,9,13,69.2,4,2,2,0,5,19,5,1
228,Mario Gila,es ESP,DF,Lazio,22,2000,3.9,8,8,8,0,0,4,7,57.1,3,7,6,1,4,12,12,0
229,Santiago Giménez,mx MEX,FW,Feyenoord,22,2001,3.9,0,0,0,0,0,0,2,0.0,2,2,0,2,1,1,4,0
230,Olivier Giroud,fr FRA,FW,Milan,36,1986,5.7,3,1,3,0,0,1,8,12.5,7,3,0,3,0,3,10,1
231,Jamie Gittens,eng ENG,FW,Dortmund,18,2004,2.3,2,1,1,0,1,1,3,33.3,2,2,0,2,1,3,2,0
232,Omri Glazer,il ISR,GK,Red Star,27,1996,6.0,0,0,0,0,0,0,1,0.0,1,0,0,0,0,0,3,3
234,Oscar Gloukh,il ISR,"MF,FW",RB Salzburg,19,2004,5.3,6,3,1,4,1,2,14,14.3,12,2,0,2,2,8,0,0
235,Serge Gnabry,de GER,FW,Bayern Munich,28,1995,2.2,4,1,2,0,2,2,4,50.0,2,7,0,7,0,4,3,0
236,Giorgi Gocholeishvili,ge GEO,DF,Shakhtar,22,2001,3.2,12,6,6,3,3,5,9,55.6,4,2,0,2,1,13,6,0
237,Sergio Gómez,es ESP,"DF,FW",Manchester City,22,2000,2.2,3,2,1,1,1,1,2,50.0,1,1,0,1,1,4,2,0
238,Victor Gomez,es ESP,DF,Braga,23,2000,3.5,10,6,6,4,0,10,15,66.7,5,3,1,2,3,13,9,0
239,Diogo Gonçalves,pt POR,MF,FC Copenhagen,26,1997,5.9,9,7,4,4,1,5,11,45.5,6,4,0,4,6,15,6,0
240,Nicolás González,es ESP,MF,Porto,21,2002,2.5,4,4,4,0,0,1,5,20.0,4,1,0,1,2,6,4,0
241,Anthony Gordon,eng ENG,FW,Newcastle Utd,22,2001,4.9,10,8,5,2,3,6,13,46.2,7,8,0,8,2,12,2,0
242,Leon Goretzka,de GER,"MF,DF",Bayern Munich,28,1995,8.5,13,9,6,5,2,8,18,44.4,10,15,6,9,19,32,20,0
243,Robin Gosens,de GER,"DF,MF",Union Berlin,29,1994,4.9,6,3,3,3,0,1,5,20.0,4,5,1,4,3,9,12,0
244,Lucas Gourna-Douath,fr FRA,MF,RB Salzburg,19,2003,4.4,10,8,4,4,2,4,12,33.3,8,7,3,4,12,22,6,0
245,Tiago Gouveia,pt POR,FW,Benfica,22,2001,0.3,0,0,0,0,0,0,1,0.0,1,0,0,0,0,0,0,0
246,Kamil Grabara,pl POL,GK,FC Copenhagen,24,1999,8.0,0,0,0,0,0,0,0,0.0,0,0,0,0,0,0,0,1
247,Jonathan Gradit,fr FRA,DF,Lens,30,1992,5.7,18,12,10,7,1,10,14,71.4,4,8,5,3,8,26,16,0
248,Jack Grealish,eng ENG,"FW,MF",Manchester City,27,1995,5.9,3,2,0,2,1,1,7,14.3,6,5,0,5,2,5,1,0
249,Antoine Griezmann,fr FRA,"FW,MF",Atlético Madrid,32,1991,9.1,12,9,5,6,1,2,13,15.4,11,9,1,8,6,18,11,0
250,Marko Grujić,rs SRB,MF,Porto,27,1996,0.6,2,1,1,0,1,1,1,100.0,0,1,0,1,0,2,1,0
251,Nemanja Gudelj,rs SRB,DF,Sevilla,31,1991,6.0,12,7,7,5,0,7,13,53.8,6,4,2,2,4,16,17,0
252,Gonçalo Guedes,pt POR,FW,Benfica,26,1996,0.3,0,0,0,0,0,0,1,0.0,1,1,0,1,0,0,0,0
253,Mattéo Guendouzi,fr FRA,MF,Lazio,24,1999,5.5,6,6,1,3,2,2,5,40.0,3,3,1,2,5,11,6,0
254,Raphaël Guerreiro,pt POR,"DF,FW",Bayern Munich,29,1993,4.3,5,2,2,3,0,1,5,20.0,4,3,0,3,4,9,4,0
255,Morgan Guilavogui,gn GUI,"FW,MF",Lens,25,1998,0.8,0,0,0,0,0,0,1,0.0,1,4,2,2,0,0,1,0
256,Bruno Guimarães,br BRA,MF,Newcastle Utd,25,1997,6.0,13,11,9,2,2,6,14,42.9,8,10,4,6,6,19,8,0
257,Marc Guiu,es ESP,FW,Barcelona,17,2006,0.4,1,0,0,1,0,1,1,100.0,0,1,0,1,0,1,3,0
258,Péter Gulácsi,hu HUN,GK,RB Leipzig,33,1990,3.0,0,0,0,0,0,0,0,0.0,0,0,0,0,0,0,1,0
260,İlkay Gündoğan,de GER,MF,Barcelona,32,1990,9.3,5,5,1,1,3,4,11,36.4,7,13,3,10,6,11,3,1
261,Joško Gvardiol,hr CRO,DF,Manchester City,21,2002,6.3,7,6,4,2,1,2,5,40.0,3,5,1,4,8,15,10,1
262,Erling Haaland,no NOR,FW,Manchester City,23,2000,8.6,5,2,0,4,1,2,3,66.7,1,1,0,1,0,5,3,0
263,Janik Haberer,de GER,MF,Union Berlin,29,1994,4.0,5,2,1,4,0,3,11,27.3,8,4,1,3,1,6,5,0
264,Amadou Haidara,ml MLI,"MF,DF",RB Leipzig,25,1998,3.0,7,3,7,0,0,7,12,58.3,5,6,1,5,2,9,4,0
265,Massadio Haïdara,ml MLI,DF,Lens,30,1992,1.3,2,2,2,0,0,1,2,50.0,1,3,2,1,2,4,3,0
266,Achraf Hakimi,ma MAR,DF,Paris S-G,24,1998,10.9,20,14,8,7,5,13,25,52.0,12,10,0,10,12,32,16,2
267,Lewis Hall,eng ENG,DF,Newcastle Utd,18,2004,0.5,1,1,1,0,0,1,1,100.0,0,0,0,0,0,1,3,0
268,Sébastien Haller,ci CIV,"FW,MF",Dortmund,29,1994,0.7,0,0,0,0,0,0,0,0.0,0,2,1,1,1,1,1,0
269,Micah Hamilton,eng ENG,FW,Manchester City,19,2003,1.2,1,1,0,0,1,1,2,50.0,1,1,0,1,1,2,0,0
270,Dávid Hancko,sk SVK,DF,Feyenoord,25,1997,6.0,3,2,2,1,0,3,3,100.0,0,4,3,1,5,8,11,0
271,Joe Hart,eng ENG,GK,Celtic,36,1987,6.0,0,0,0,0,0,0,0,0.0,0,0,0,0,0,0,5,0
272,Quilindschy Hartman,nl NED,DF,Feyenoord,21,2001,6.0,15,14,6,5,4,5,9,55.6,4,14,4,10,7,22,10,0
273,Reo Hatate,jp JPN,MF,Celtic,25,1997,1.5,0,0,0,0,0,0,2,0.0,2,1,0,1,0,0,1,0
274,Kai Havertz,de GER,"MF,FW",Arsenal,24,1999,9.2,16,5,0,12,4,8,15,53.3,7,10,0,10,3,19,6,0
275,Benjamin Henrichs,de GER,"DF,MF",RB Leipzig,26,1997,5.5,22,14,13,6,3,10,18,55.6,8,10,2,8,3,25,11,0
276,Mario Hermoso,es ESP,DF,Atlético Madrid,28,1995,9.1,7,6,4,2,1,3,12,25.0,9,9,3,6,6,13,25,1
277,Lucas Hernández,fr FRA,DF,Paris S-G,27,1996,9.3,15,10,7,7,1,11,15,73.3,4,6,0,6,3,18,20,1
278,Theo Hernández,fr FRA,DF,Milan,25,1997,6.0,7,5,5,2,0,4,5,80.0,1,4,2,2,5,12,16,0
279,André Horta,pt POR,MF,Braga,26,1996,0.4,3,3,1,0,2,3,6,50.0,3,0,0,0,0,3,0,0
280,Ricardo Horta,pt POR,"FW,MF",Braga,28,1994,5.6,7,4,2,3,2,2,9,22.2,7,2,0,2,3,10,2,0
281,Mats Hummels,de GER,DF,Dortmund,34,1988,13.0,53,29,43,10,0,34,48,70.8,14,20,8,12,25,78,69,2
282,Oh Hyeon-gyu,kr KOR,"FW,MF",Celtic,22,2001,1.2,1,0,0,0,1,0,2,0.0,2,0,0,0,0,1,1,0
283,Elseid Hysaj,al ALB,DF,Lazio,29,1994,3.8,8,3,4,4,0,2,5,40.0,3,3,0,3,2,10,6,0
284,Yang Hyunjun,kr KOR,FW,Celtic,21,2002,2.3,4,3,2,0,2,2,6,33.3,4,4,1,3,3,7,1,0
286,Oscar Højlund,dk DEN,MF,FC Copenhagen,18,2005,0.5,3,2,1,2,0,2,2,100.0,0,1,0,1,0,3,1,0
287,Rasmus Højlund,dk DEN,FW,Manchester Utd,20,2003,5.4,0,0,0,0,0,0,0,0.0,0,3,0,3,1,1,0,0
288,Mauro Icardi,ar ARG,FW,Galatasaray,30,1993,5.8,2,2,1,1,0,1,1,100.0,0,0,0,0,0,2,3,0
289,George Ilenikhena,ng NGA,FW,Antwerp,16,2006,1.7,1,0,1,0,0,1,1,100.0,0,0,0,0,0,1,1,0
290,Ciro Immobile,it ITA,FW,Lazio,33,1990,5.6,2,1,0,2,0,1,4,25.0,3,5,1,4,1,3,6,0
291,Hwang In-beom,kr KOR,MF,Red Star,26,1996,5.9,19,10,8,7,4,6,14,42.9,8,5,1,4,5,24,4,0
292,Alexander Isak,se SWE,FW,Newcastle Utd,23,1999,3.5,1,0,0,1,0,1,1,100.0,0,3,2,1,0,1,2,0
293,Gustav Isaksen,dk DEN,FW,Lazio,22,2001,2.7,0,0,0,0,0,0,4,0.0,4,1,0,1,2,2,1,0
294,Cedric Itten,ch SUI,FW,Young Boys,26,1996,3.1,2,2,1,1,0,1,2,50.0,1,3,0,3,0,2,3,0
295,Mirko Ivanić,me MNE,MF,Red Star,29,1993,4.1,7,2,3,3,1,5,11,45.5,6,9,2,7,7,14,8,0
296,Luka Ivanušec,hr CRO,"FW,MF",Feyenoord,24,1998,2.3,3,2,1,1,1,2,6,33.3,4,2,0,2,1,4,1,0
297,Tomoki Iwata,jp JPN,"MF,FW",Celtic,26,1997,0.7,3,3,1,2,0,3,4,75.0,1,0,0,0,0,3,2,0
298,Paul Jaeckel,de GER,DF,Union Berlin,25,1998,1.9,2,1,2,0,0,2,3,66.7,1,5,5,0,4,6,7,0
299,Alireza Jahanbakhsh,ir IRN,"FW,DF",Feyenoord,29,1993,0.8,6,1,0,4,2,2,2,100.0,0,0,0,0,1,7,0,0
300,Ivan Jaime Pajuelo,es ESP,MF,Porto,22,2000,1.0,6,3,0,4,2,2,2,100.0,0,0,0,0,0,6,1,0
301,Saidy Janko,gm GAM,DF,Young Boys,27,1995,3.6,4,2,2,1,1,3,7,42.9,4,8,2,6,1,5,7,0
302,Vincent Janssen,nl NED,FW,Antwerp,29,1994,4.5,4,3,0,2,2,3,8,37.5,5,4,0,4,0,4,7,0
303,Elias Jelert,dk DEN,DF,FC Copenhagen,20,2003,6.5,11,8,9,0,2,7,12,58.3,5,11,4,7,4,15,19,0
304,Gabriel Jesus,br BRA,FW,Arsenal,26,1997,4.5,8,4,1,6,1,1,5,20.0,4,7,0,7,1,9,3,0
305,Juan Jesus,br BRA,DF,Napoli,32,1991,4.8,11,4,3,7,1,4,6,66.7,2,6,3,3,4,15,17,0
306,Joelinton,br BRA,"MF,FW",Newcastle Utd,26,1996,3.7,5,3,3,2,0,1,6,16.7,5,6,2,4,4,9,7,0
307,Alistair Johnston,ca CAN,DF,Celtic,24,1998,6.0,15,7,11,4,0,9,13,69.2,4,9,4,5,4,19,13,0
308,Michael Johnston,ie IRL,FW,Celtic,24,1999,1.1,3,3,0,1,2,1,2,50.0,1,4,1,3,1,4,2,0
309,Frenkie de Jong,nl NED,MF,Barcelona,26,1997,4.4,9,3,1,6,2,3,6,50.0,3,2,1,1,3,12,5,0
310,Luuk de Jong,nl NED,FW,PSV Eindhoven,32,1990,7.0,5,5,1,3,1,2,2,100.0,0,7,2,5,1,6,4,0
312,Joan Jordán,es ESP,MF,Sevilla,29,1994,0.9,5,2,3,2,0,3,4,75.0,1,0,0,0,0,5,0,0
313,Jorginho,it ITA,MF,Arsenal,31,1991,5.9,16,8,4,8,4,5,9,55.6,4,6,2,4,9,25,4,0
314,Joselu,es ESP,FW,Real Madrid,33,1990,3.1,1,0,1,0,0,0,0,0.0,0,0,0,0,0,1,4,0
315,Luka Jović,rs SRB,"FW,MF",Milan,25,1997,0.4,0,0,0,0,0,0,0,0.0,0,1,0,1,0,0,0,0
316,Mauro Júnior,br BRA,"MF,DF",PSV Eindhoven,24,1999,2.0,2,1,1,1,0,1,3,33.3,2,2,0,2,4,6,2,0
317,Hamed Junior Traorè,ci CIV,MF,Napoli,23,2000,1.1,0,0,0,0,0,0,0,0.0,0,3,0,3,2,2,0,0
318,Vinicius Júnior,br BRA,FW,Real Madrid,23,2000,10.0,8,5,5,3,0,1,3,33.3,2,7,1,6,1,9,1,0
319,Josip Juranović,hr CRO,DF,Union Berlin,27,1995,4.6,6,1,5,1,0,4,8,50.0,4,7,3,4,2,8,11,1
320,David Jurásek,cz CZE,"MF,DF",Benfica,22,2000,1.4,6,2,3,1,2,4,11,36.4,7,2,0,2,1,7,4,0
321,Uroš Kabić,rs SRB,DF,Red Star,19,2004,0.1,1,0,1,0,0,1,1,100.0,0,0,0,0,0,1,0,0
322,Pierre Kalulu,fr FRA,DF,Milan,23,2000,1.0,0,0,0,0,0,0,1,0.0,1,1,0,1,2,2,2,0
323,Daichi Kamada,jp JPN,MF,Lazio,26,1996,2.9,7,3,1,4,2,4,5,80.0,1,4,1,3,1,8,2,0
324,Dijon Kameri,at AUT,MF,RB Salzburg,19,2004,0.1,0,0,0,0,0,0,0,0.0,0,1,0,1,0,0,1,0
325,Kevin Kampl,si SVN,MF,RB Leipzig,32,1990,3.1,8,7,2,6,0,4,6,66.7,2,4,1,3,4,12,6,0
326,Harry Kane,eng ENG,FW,Bayern Munich,30,1993,11.8,9,7,3,5,1,3,4,75.0,1,9,2,7,1,10,7,0
327,Lee Kang-in,kr KOR,"MF,FW",Paris S-G,22,2001,3.8,7,4,2,3,2,5,11,45.5,6,5,0,5,2,9,2,0
328,Guélor Kanga,ga GAB,MF,Red Star,32,1990,1.6,4,2,1,3,0,2,8,25.0,6,1,0,1,0,4,0,0
329,Kings Kangwa,zm ZAM,MF,Red Star,24,1999,0.1,1,0,0,1,0,1,2,50.0,1,0,0,0,0,1,0,0
330,Kazımcan Karataş,tr TUR,DF,Galatasaray,20,2003,0.8,4,4,2,1,1,2,3,66.7,1,0,0,0,1,5,2,1
331,Oleksii Kashchuk,ua UKR,FW,Shakhtar,23,2000,0.3,0,0,0,0,0,0,0,0.0,0,1,0,1,0,0,0,0
332,Aleksandar Katai,rs SRB,"MF,FW",Red Star,32,1991,0.9,2,1,1,1,0,1,1,100.0,0,0,0,0,0,2,1,0
333,Mandela Keita,be BEL,MF,Antwerp,21,2002,2.9,8,7,6,2,0,5,8,62.5,3,2,0,2,2,10,4,0
334,Kevin Kelsy,ve VEN,FW,Shakhtar,19,2004,1.5,2,0,1,1,0,1,3,33.3,2,1,0,1,0,2,1,0
335,Aljoscha Kemlein,de GER,MF,Union Berlin,18,2004,0.1,0,0,0,0,0,0,0,0.0,0,1,1,0,0,0,1,0
336,Gyrano Kerk,sr SUR,FW,Antwerp,27,1995,2.3,3,3,0,3,0,1,6,16.7,5,3,0,3,0,3,1,0
338,Rani Khedira,de GER,MF,Union Berlin,29,1994,3.2,6,4,2,3,1,1,5,20.0,4,5,1,4,2,8,3,0
339,Abdukodir Khusanov,uz UZB,DF,Lens,19,2004,0.3,2,1,2,0,0,2,3,66.7,1,1,0,1,0,2,0,0
340,Joshua Kimmich,de GER,"MF,DF",Bayern Munich,28,1995,12.0,23,16,12,10,1,15,39,38.5,24,9,0,9,11,34,16,1
341,Jakub Kiwior,pl POL,DF,Arsenal,23,2000,4.2,8,4,3,4,1,4,13,30.8,9,1,1,0,2,10,4,0
342,Simon Kjær,dk DEN,DF,Milan,34,1989,0.0,0,0,0,0,0,0,0,0.0,0,0,0,0,0,0,0,0
343,Maurits Kjærgaard,dk DEN,"MF,FW",RB Salzburg,20,2003,2.3,2,1,0,1,1,1,4,25.0,3,4,1,3,1,3,2,0
344,Davy Klaassen,nl NED,"MF,FW",Inter,30,1993,0.9,1,1,0,0,1,0,2,0.0,2,0,0,0,0,1,0,0
345,Lukas Klostermann,de GER,DF,RB Leipzig,27,1996,4.0,6,3,4,2,0,5,8,62.5,3,4,2,2,4,10,23,0
346,Robin Knoche,de GER,DF,Union Berlin,31,1992,3.0,6,2,5,1,0,3,8,37.5,5,4,4,0,3,9,10,1
347,Gregor Kobel,ch SUI,GK,Dortmund,25,1997,12.0,0,0,0,0,0,0,1,0.0,1,0,0,0,0,0,9,0
348,Sekou Koita,ml MLI,FW,RB Salzburg,23,1999,0.8,2,2,0,1,1,1,1,100.0,0,2,0,2,0,2,3,0
349,Orkun Kökçü,tr TUR,MF,Benfica,22,2000,2.9,6,2,3,2,1,3,9,33.3,6,3,1,2,0,6,2,0
350,Koke,es ESP,MF,Atlético Madrid,31,1992,8.6,15,11,6,4,5,10,18,55.6,8,6,2,4,3,18,12,0
351,Randal Kolo Muani,fr FRA,"FW,MF",Paris S-G,24,1998,5.2,7,3,4,2,1,0,1,0.0,1,5,1,4,1,8,4,0
352,Karim Konaté,ci CIV,"FW,MF",RB Salzburg,19,2004,2.6,2,2,1,1,0,1,3,33.3,2,1,0,1,3,5,4,0
353,Yukhym Konoplia,ua UKR,DF,Shakhtar,23,1999,2.8,8,5,4,4,0,6,8,75.0,2,3,0,3,6,14,3,0
354,Ilias Kostis,gr GRE,FW,Atlético Madrid,20,2003,0.0,0,0,0,0,0,0,0,0.0,0,0,0,0,0,0,0,0
355,Jules Koundé,fr FRA,DF,Barcelona,24,1998,8.0,11,7,6,2,3,4,9,44.4,5,12,6,6,10,21,32,0
356,Mateo Kovačić,hr CRO,MF,Manchester City,29,1994,4.8,7,2,2,5,0,2,8,25.0,6,3,1,2,5,12,3,0
357,Alex Král,cz CZE,MF,Union Berlin,25,1998,2.8,7,4,4,2,1,3,6,50.0,3,3,1,2,2,9,2,0
358,Jean-Philippe Krasso,ci CIV,"FW,MF",Red Star,26,1997,1.2,3,2,0,2,1,0,1,0.0,1,1,0,1,1,4,0,0
359,Frans Krätzig,de GER,DF,Bayern Munich,20,2003,0.1,0,0,0,0,0,0,0,0.0,0,1,1,0,0,0,1,0
360,Toni Kroos,de GER,MF,Real Madrid,33,1990,9.5,21,12,10,9,2,10,24,41.7,14,4,0,4,12,33,9,0
361,Rade Krunić,ba BIH,"MF,DF",Milan,29,1993,2.3,4,2,3,0,1,1,5,20.0,4,0,0,0,3,7,4,0
362,Dmytro Kryskiv,ua UKR,"MF,FW",Shakhtar,22,2000,4.3,7,3,4,3,0,1,10,10.0,9,6,0,6,1,8,3,0
364,Takefusa Kubo,jp JPN,"FW,MF",Real Sociedad,22,2001,6.2,4,3,0,3,1,0,7,0.0,7,4,1,3,2,6,4,0
365,Khvicha Kvaratskhelia,ge GEO,FW,Napoli,22,2001,7.4,8,5,1,4,3,3,7,42.9,4,8,0,8,4,12,2,0
366,Gustaf Lagerbielke,se SWE,DF,Celtic,23,2000,0.9,2,0,2,0,0,1,1,100.0,0,3,2,1,2,4,1,0
367,Aïssa Laïdouni,tn TUN,MF,Union Berlin,26,1996,3.1,5,5,1,2,2,0,3,0.0,3,3,1,2,1,6,5,0
368,Konrad Laimer,at AUT,"MF,DF",Bayern Munich,26,1997,8.6,32,22,19,8,5,14,34,41.2,20,14,3,11,8,40,13,0
369,Érik Lamela,ar ARG,"FW,MF",Sevilla,31,1992,2.1,7,3,3,2,2,3,4,75.0,1,4,0,4,2,9,0,0
370,Senne Lammens,be BEL,GK,Antwerp,21,2002,1.0,0,0,0,0,0,0,0,0.0,0,0,0,0,0,0,0,1
371,Noa Lang,nl NED,FW,PSV Eindhoven,24,1999,1.8,2,0,0,1,1,0,3,0.0,3,1,0,1,1,3,0,0
372,Jordan Larsson,se SWE,"FW,MF",FC Copenhagen,26,1997,1.2,0,0,0,0,0,0,3,0.0,3,0,0,0,1,1,0,0
373,Jamaal Lascelles,eng ENG,DF,Newcastle Utd,29,1993,5.0,5,5,3,1,1,3,3,100.0,0,6,3,3,0,5,16,0
374,Sandro Lauper,ch SUI,MF,Young Boys,26,1996,3.1,4,2,0,1,3,1,9,11.1,8,7,2,5,2,6,1,0
375,Manuel Lazzari,it ITA,DF,Lazio,29,1993,4.7,10,7,3,7,0,6,15,40.0,9,13,3,10,5,15,6,0
376,Robin Le Normand,es ESP,DF,Real Sociedad,26,1996,6.4,8,5,6,1,1,4,9,44.4,5,2,1,1,11,19,16,0
377,Rafael Leão,pt POR,FW,Milan,24,1999,4.9,8,1,5,1,2,2,5,40.0,3,2,0,2,2,10,1,0
378,Diogo Leite,pt POR,DF,Union Berlin,24,1999,6.0,11,5,9,2,0,7,16,43.8,9,15,9,6,5,16,30,0
379,Stav Lemkin,il ISR,DF,Shakhtar,20,2003,0.7,1,0,1,0,0,0,1,0.0,1,0,0,0,0,1,1,0
380,Christopher Lenz,de GER,DF,RB Leipzig,28,1994,1.0,6,6,5,1,0,4,8,50.0,4,4,0,4,0,6,1,0
381,Lukas Lerager,dk DEN,MF,FC Copenhagen,30,1993,6.0,17,8,9,6,2,10,18,55.6,8,9,1,8,8,25,13,0
382,Robert Lewandowski,pl POL,FW,Barcelona,34,1988,8.2,7,5,0,4,3,5,7,71.4,2,7,1,6,0,7,8,0
383,Rico Lewis,eng ENG,"MF,DF",Manchester City,18,2004,6.1,8,5,4,1,3,3,5,60.0,2,8,2,6,3,11,4,0
384,Matthijs de Ligt,nl NED,DF,Bayern Munich,23,1999,5.2,8,6,5,3,0,6,8,75.0,2,7,5,2,3,11,24,0
385,Victor Lindelöf,se SWE,DF,Manchester Utd,29,1994,3.3,0,0,0,0,0,0,1,0.0,1,6,2,4,1,1,11,0
386,Jesper Lindstrøm,dk DEN,FW,Napoli,23,2000,0.7,6,3,1,3,2,3,4,75.0,1,1,0,1,0,6,0,0
387,Ondřej Lingr,cz CZE,"FW,MF",Feyenoord,24,1998,0.8,0,0,0,0,0,0,3,0.0,3,0,0,0,0,0,1,0
388,Samuel Lino,br BRA,DF,Atlético Madrid,23,1999,5.6,12,10,8,2,2,7,18,38.9,11,14,0,14,2,14,4,0
390,Valentino Livramento,eng ENG,"DF,FW",Newcastle Utd,20,2002,3.0,9,6,3,5,1,4,5,80.0,1,5,1,4,1,10,9,1
391,Marcos Llorente,es ESP,"MF,DF",Atlético Madrid,28,1995,7.2,10,9,7,2,1,6,12,50.0,6,10,2,8,3,13,8,0
392,Danny Loader,cm CMR,"MF,FW",Porto,22,2000,0.2,0,0,0,0,0,0,0,0.0,0,0,0,0,0,0,0,0
393,Stanislav Lobotka,sk SVK,MF,Napoli,28,1994,7.5,11,5,6,5,0,6,15,40.0,9,7,2,5,10,21,7,1
394,Ruben Loftus-Cheek,eng ENG,MF,Milan,27,1996,3.6,3,3,1,1,1,1,2,50.0,1,1,0,1,0,3,2,0
395,Sean Longstaff,eng ENG,MF,Newcastle Utd,25,1997,3.9,7,3,3,4,0,2,5,40.0,3,7,1,6,2,9,2,0
396,Rony Lopes,pt POR,FW,Braga,27,1995,0.0,0,0,0,0,0,0,0,0.0,0,1,0,1,0,0,0,0
397,Fermin López,es ESP,MF,Barcelona,20,2003,3.1,10,7,2,8,0,4,11,36.4,7,3,0,3,2,12,0,0
398,Marcos López,pe PER,DF,Feyenoord,23,1999,0.5,0,0,0,0,0,0,0,0.0,0,0,0,0,1,1,1,0
399,Hirving Lozano,mx MEX,FW,PSV Eindhoven,28,1995,4.2,5,4,2,3,0,2,8,25.0,6,5,0,5,2,7,4,0
400,Vladimir Lučić,rs SRB,"DF,FW",Red Star,21,2002,2.3,2,2,1,0,1,1,5,20.0,4,3,0,3,1,3,1,0
401,Florentino Luís,pt POR,MF,Benfica,23,1999,1.2,3,2,0,2,1,1,3,33.3,2,1,0,1,3,6,1,1
402,Castello Lukeba,fr FRA,DF,RB Leipzig,20,2002,6.9,7,3,6,1,0,6,10,60.0,4,7,3,4,16,23,16,2
403,Dodi Lukebakio,be BEL,FW,Sevilla,25,1997,2.7,2,2,0,2,0,1,4,25.0,3,1,0,1,1,3,0,0
404,Valdemar Lund,dk DEN,DF,FC Copenhagen,20,2003,0.3,0,0,0,0,0,0,0,0.0,0,1,0,1,0,0,0,0
405,Andriy Lunin,ua UKR,GK,Real Madrid,24,1999,8.3,0,0,0,0,0,0,1,0.0,1,0,0,0,0,0,6,1
406,Fabian Lustenberger,ch SUI,DF,Young Boys,35,1988,1.0,2,1,1,1,0,1,1,100.0,0,2,1,1,3,5,2,0
407,Ian Maatsen,nl NED,DF,Dortmund,21,2002,7.0,15,11,8,7,0,8,17,47.1,9,12,2,10,12,27,31,2
408,Deiver Machado,co COL,DF,Lens,29,1993,4.1,10,7,5,5,0,5,6,83.3,1,5,0,5,2,12,10,0
409,Daizen Maeda,jp JPN,FW,Celtic,25,1997,3.1,2,1,0,2,0,2,7,28.6,5,2,0,2,3,5,3,0
410,Gabriel Magalhães,br BRA,DF,Arsenal,25,1997,10.3,9,7,3,5,1,3,4,75.0,1,8,6,2,3,12,35,0
411,Harry Maguire,eng ENG,DF,Manchester Utd,30,1993,3.4,1,1,1,0,0,1,1,100.0,0,6,3,3,4,5,13,0
412,Jon Magunazelaia,es ESP,MF,Real Sociedad,22,2001,0.2,0,0,0,0,0,0,0,0.0,0,0,0,0,0,0,1,0
413,Mike Maignan,fr FRA,GK,Milan,28,1995,5.9,0,0,0,0,0,0,0,0.0,0,0,0,0,0,0,4,0
414,Kobbie Mainoo,eng ENG,MF,Manchester Utd,18,2005,0.5,2,1,1,1,0,0,0,0.0,0,1,1,0,0,2,2,0
416,Donyell Malen,nl NED,FW,Dortmund,24,1999,5.1,3,1,0,3,0,0,0,0.0,0,4,0,4,0,3,5,0
417,Darian Males,ch SUI,MF,Young Boys,22,2001,1.9,3,2,1,2,0,1,1,100.0,0,3,0,3,1,4,1,0
418,Reinildo Mandava,mz MOZ,DF,Atlético Madrid,29,1994,0.3,1,0,1,0,0,0,0,0.0,0,2,2,0,2,3,2,1
419,José María Giménez,uy URU,DF,Atlético Madrid,28,1995,5.3,1,1,1,0,0,0,3,0.0,3,8,6,2,5,6,34,0
420,Mariano,do DOM,"MF,FW",Sevilla,29,1993,0.7,1,1,0,1,0,0,0,0.0,0,1,0,1,0,1,0,0
421,Adrián Marín,es ESP,DF,Braga,26,1997,0.3,0,0,0,0,0,0,1,0.0,1,1,0,1,0,0,1,0
422,João Mário,pt POR,"FW,MF",Benfica,30,1993,3.6,2,1,1,0,1,2,8,25.0,6,2,0,2,2,4,3,0
423,João Mário Lopes,pt POR,DF,Porto,23,2000,6.6,21,15,14,6,1,14,26,53.8,12,8,0,8,2,23,11,0
424,Marquinhos,br BRA,DF,Paris S-G,29,1994,10.0,17,7,14,2,1,11,17,64.7,6,12,9,3,12,29,29,1
425,Anthony Martial,fr FRA,"FW,DF",Manchester Utd,27,1995,0.6,0,0,0,0,0,0,0,0.0,0,0,0,0,1,1,1,0
426,Gabriel Martinelli,br BRA,FW,Arsenal,22,2001,5.3,4,2,2,0,2,3,4,75.0,1,8,0,8,2,6,1,0
427,Iñigo Martínez,es ESP,DF,Barcelona,32,1991,3.5,2,1,1,0,1,2,4,50.0,2,3,2,1,3,5,13,0
428,Lautaro Martínez,ar ARG,FW,Inter,25,1997,5.9,5,1,1,3,1,1,5,20.0,4,6,0,6,1,6,3,0
429,Lisandro Martínez,ar ARG,DF,Manchester Utd,25,1998,1.0,0,0,0,0,0,0,0,0.0,0,4,2,2,2,2,1,1
430,Toni Martínez,es ESP,FW,Porto,26,1997,0.1,0,0,0,0,0,0,0,0.0,0,0,0,0,0,0,2,0
431,Adam Marušić,me MNE,DF,Lazio,30,1992,5.7,9,8,2,7,0,5,7,71.4,2,6,5,1,8,17,10,0
432,Matheus,br BRA,GK,Braga,31,1992,6.0,0,0,0,0,0,0,0,0.0,0,0,0,0,0,0,1,0
433,Magnus Mattsson,dk DEN,MF,FC Copenhagen,24,1999,1.3,6,4,1,3,2,3,4,75.0,1,1,0,1,0,6,2,0
434,Mykola Matviyenko,ua UKR,DF,Shakhtar,27,1996,5.0,11,5,7,3,1,6,15,40.0,9,10,5,5,2,13,29,2
435,Eric Maxim Choupo-Moting,cm CMR,"FW,MF",Bayern Munich,34,1989,0.5,1,1,0,1,0,0,0,0.0,0,0,0,0,0,1,2,0
436,Noussair Mazraoui,ma MAR,DF,Bayern Munich,25,1997,7.2,17,11,8,7,2,8,15,53.3,7,8,3,5,7,24,8,0
437,Kylian Mbappé,fr FRA,FW,Paris S-G,24,1998,12.0,2,1,1,0,1,2,4,50.0,2,3,0,3,4,6,0,0
438,Callum McGregor,sct SCO,MF,Celtic,30,1993,5.8,4,4,1,2,1,2,7,28.6,5,12,6,6,6,10,17,0
439,Scott McKenna,sct SCO,DF,FC Copenhagen,26,1996,2.0,2,2,1,0,1,1,1,100.0,0,6,6,0,2,4,6,0
440,Scott McTominay,sct SCO,MF,Manchester Utd,26,1996,4.2,2,1,1,1,0,1,7,14.3,6,5,3,2,1,3,6,0
442,Facundo Medina,ar ARG,DF,Lens,24,1999,5.5,9,6,5,4,0,6,7,85.7,1,10,0,10,5,14,13,0
443,Hannibal Mejbri,tn TUN,"MF,FW",Manchester Utd,20,2003,0.7,2,1,1,1,0,1,2,50.0,1,0,0,0,0,2,0,0
444,Birger Meling,no NOR,DF,FC Copenhagen,28,1994,2.1,7,5,4,2,1,3,6,50.0,3,2,0,2,0,7,5,0
445,Memphis,nl NED,FW,Atlético Madrid,29,1994,1.2,0,0,0,0,0,0,1,0.0,1,1,1,0,1,1,0,0
446,Joe Mendes,se SWE,DF,Braga,20,2002,2.3,3,1,2,0,1,2,3,66.7,1,3,1,2,2,5,4,0
447,Nuno Mendes,pt POR,DF,Paris S-G,21,2002,4.7,11,8,6,4,1,6,18,33.3,12,8,2,6,9,20,11,0
448,Brais Méndez,es ESP,MF,Real Sociedad,26,1997,5.8,13,8,0,8,5,6,10,60.0,4,7,1,6,3,16,8,0
449,Ferland Mendy,fr FRA,DF,Real Madrid,28,1995,9.7,14,9,10,3,1,10,14,71.4,4,10,1,9,6,20,16,0
450,Nampalys Mendy,sn SEN,MF,Lens,31,1992,4.1,8,4,4,2,2,4,8,50.0,4,0,0,0,7,15,7,0
451,Alex Meret,it ITA,GK,Napoli,26,1997,8.0,0,0,0,0,0,0,0,0.0,0,0,0,0,0,0,4,0
452,Mikel Merino,es ESP,MF,Real Sociedad,27,1996,7.0,15,8,8,4,3,6,13,46.2,7,8,1,7,4,19,15,0
453,Dries Mertens,be BEL,MF,Galatasaray,36,1987,2.2,0,0,0,0,0,0,1,0.0,1,6,0,6,2,2,2,0
454,Alexander Meyer,de GER,GK,Dortmund,32,1991,1.0,0,0,0,0,0,0,0,0.0,0,0,0,0,0,0,0,0
455,Srđan Mijailović,rs SRB,"DF,MF",Red Star,29,1993,5.4,14,5,3,9,2,7,17,41.2,10,14,9,5,6,20,9,0
456,Jovan Mijatović,rs SRB,"FW,MF",Red Star,18,2005,1.3,0,0,0,0,0,0,1,0.0,1,1,0,1,0,0,0,0
457,Antoni Milambo,nl NED,"DF,MF",Feyenoord,18,2005,0.4,0,0,0,0,0,0,0,0.0,0,0,0,0,1,1,0,0
458,Lewis Miley,eng ENG,MF,Newcastle Utd,17,2006,1.9,3,1,1,2,0,2,8,25.0,6,5,3,2,2,5,8,0
459,Éder Militão,br BRA,DF,Real Madrid,25,1998,0.1,1,1,1,0,0,0,0,0.0,0,0,0,0,0,1,4,0
460,Kim Min-jae,kr KOR,DF,Bayern Munich,26,1996,7.3,10,5,7,3,0,2,6,33.3,4,13,8,5,17,27,24,0
461,Yankuba Minteh,gm GAM,FW,Feyenoord,19,2004,2.2,9,8,3,4,2,6,10,60.0,4,1,0,1,1,10,0,0
462,Rafa Mir,es ESP,FW,Sevilla,26,1997,0.4,0,0,0,0,0,0,0,0.0,0,0,0,0,1,1,0,0
463,Stefan Mitrović,rs SRB,"DF,FW",Red Star,20,2002,2.3,0,0,0,0,0,0,1,0.0,1,5,3,2,1,1,1,0
464,Henrikh Mkhitaryan,am ARM,MF,Inter,34,1989,5.7,10,5,5,5,0,3,8,37.5,5,10,3,7,8,18,10,0
465,Luka Modrić,hr CRO,MF,Real Madrid,37,1985,4.7,6,6,3,2,1,4,6,66.7,2,0,0,0,5,11,6,1
466,Nahuel Molina,ar ARG,DF,Atlético Madrid,25,1998,8.7,24,15,15,7,2,18,30,60.0,12,20,2,18,7,31,16,0
468,Joel Monteiro,ch SUI,"FW,MF",Young Boys,23,1999,2.9,8,4,1,6,1,4,8,50.0,4,1,0,1,3,11,3,0
469,Álvaro Morata,es ESP,FW,Atlético Madrid,30,1992,7.4,5,3,2,1,2,2,4,50.0,2,6,1,5,0,5,9,0
470,Morato,br BRA,DF,Benfica,22,2001,4.8,15,10,9,6,0,13,19,68.4,6,8,3,5,6,21,17,0
471,Leandro Morgalla,de GER,DF,RB Salzburg,18,2004,0.5,0,0,0,0,0,0,0,0.0,0,3,1,2,0,0,0,0
472,Youssoufa Moukoko,de GER,FW,Dortmund,18,2004,0.2,1,0,0,0,1,0,0,0.0,0,1,0,1,0,1,1,0
473,Mason Mount,eng ENG,"MF,FW",Manchester Utd,24,1999,1.0,2,1,1,0,1,0,0,0.0,0,0,0,0,1,3,0,0
474,João Moutinho,pt POR,MF,Braga,36,1986,3.2,8,4,2,5,1,4,10,40.0,6,4,1,3,7,15,1,0
475,Arbnor Muja,al ALB,FW,Antwerp,24,1998,4.0,5,3,3,0,2,1,6,16.7,5,4,0,4,0,5,1,0
476,Nordi Mukiele,fr FRA,DF,Paris S-G,25,1997,0.6,0,0,0,0,0,0,0,0.0,0,2,1,1,0,0,1,0
477,Thomas Müller,de GER,MF,Bayern Munich,33,1989,4.7,5,4,2,2,1,3,9,33.3,6,6,0,6,1,6,4,0
478,Aihen Muñoz,es ESP,DF,Real Sociedad,25,1997,5.3,13,9,7,4,2,7,10,70.0,3,7,3,4,3,16,16,0
479,Jacob Murphy,eng ENG,FW,Newcastle Utd,28,1995,1.0,2,2,1,0,1,1,2,50.0,1,1,1,0,0,2,1,0
480,Petar Musa,hr CRO,"FW,MF",Benfica,25,1998,2.6,6,3,1,5,0,1,3,33.3,2,2,0,2,1,7,2,0
481,Yunus Musah,us USA,MF,Milan,20,2002,3.9,6,3,2,3,1,2,2,100.0,0,4,2,2,2,8,3,0
482,Jamal Musiala,de GER,"MF,FW",Bayern Munich,20,2003,9.7,12,10,4,7,1,8,17,47.1,9,11,1,10,12,24,0,0
483,Fernando Muslera,uy URU,GK,Galatasaray,37,1986,6.0,2,0,2,0,0,2,2,100.0,0,0,0,0,0,2,9,0
484,Almoatasem Al Musrati,ly LBY,MF,Braga,27,1996,3.4,9,7,4,4,1,3,8,37.5,5,2,0,2,8,17,6,0
485,Nacho,es ESP,DF,Real Madrid,33,1990,10.9,10,8,6,4,0,3,8,37.5,5,4,3,1,10,20,32,0
486,Natan,br BRA,DF,Napoli,22,2001,5.0,10,6,7,2,1,6,9,66.7,3,14,11,3,5,15,20,0
487,Fran Navarro,es ESP,FW,Porto,25,1998,0.1,0,0,0,0,0,0,0,0.0,0,1,0,1,0,0,0,0
488,Jesús Navas,es ESP,DF,Sevilla,37,1985,2.4,8,7,4,3,1,2,2,100.0,0,3,1,2,2,10,9,0
489,Yehor Nazaryna,ua UKR,MF,Shakhtar,26,1997,2.3,4,3,1,2,1,3,6,50.0,3,3,1,2,2,6,5,0
490,Cherif Ndiaye,sn SEN,FW,Red Star,27,1996,4.0,4,2,1,1,2,1,2,50.0,1,2,0,2,1,5,6,0
491,Tanguy Ndombele,fr FRA,MF,Galatasaray,26,1996,1.0,3,3,0,3,0,1,2,50.0,1,1,0,1,0,3,1,0
492,Kosta Nedeljković,rs SRB,DF,Red Star,17,2005,2.6,4,2,2,1,1,1,5,20.0,4,5,1,4,1,5,2,0
494,Reiss Nelson,eng ENG,FW,Arsenal,23,1999,2.0,6,3,0,3,3,4,6,66.7,2,1,0,1,1,7,0,0
495,Victor Nelsson,dk DEN,DF,Galatasaray,24,1998,1.1,3,1,3,0,0,3,3,100.0,0,1,1,0,0,3,6,1
496,David Neres,br BRA,FW,Benfica,26,1997,2.0,2,2,1,1,0,0,3,0.0,3,3,0,3,1,3,2,0
497,Manuel Neuer,de GER,GK,Bayern Munich,37,1986,9.0,0,0,0,0,0,0,0,0.0,0,0,0,0,0,0,4,1
498,João Neves,pt POR,MF,Benfica,18,2004,6.0,24,18,14,7,3,12,20,60.0,8,8,2,6,10,34,10,0
499,Newerton,br BRA,"MF,FW",Shakhtar,18,2005,2.4,5,3,1,0,4,3,10,30.0,7,3,1,2,0,5,2,0
500,Cyril Ngonge,be BEL,FW,Napoli,23,2000,0.0,0,0,0,0,0,0,0,0.0,0,0,0,0,0,0,0,0
501,Sikou Niakaté,ml MLI,DF,Braga,24,1999,4.3,6,3,5,1,0,4,6,66.7,2,8,8,0,5,11,22,0
502,Tanguy Nianzou,fr FRA,DF,Sevilla,21,2002,0.4,0,0,0,0,0,0,0,0.0,0,0,0,0,1,1,1,0
503,Bart Nieuwkoop,nl NED,DF,Feyenoord,27,1996,0.9,3,2,1,1,1,3,6,50.0,3,1,0,1,0,3,0,1
504,Saúl Ñíguez,es ESP,MF,Atlético Madrid,28,1994,4.8,8,5,6,1,1,6,9,66.7,3,10,2,8,6,14,11,0
505,Eddie Nketiah,eng ENG,FW,Arsenal,24,1999,1.6,0,0,0,0,0,0,0,0.0,0,0,0,0,0,0,1,0
506,Felix Nmecha,de GER,MF,Dortmund,22,2000,3.9,8,3,3,4,1,1,7,14.3,6,2,0,2,5,13,6,0
507,Jean-Pierre Nsame,cm CMR,FW,Young Boys,30,1993,1.8,3,2,0,2,1,2,2,100.0,0,1,0,1,0,3,2,0
508,Matheus Nunes,pt POR,"MF,FW",Manchester City,24,1998,4.7,4,2,0,3,1,3,5,60.0,2,2,0,2,3,7,2,0
509,Ørjan Nyland,no NOR,GK,Sevilla,32,1990,2.0,0,0,0,0,0,0,1,0.0,1,0,0,0,0,0,0,0
510,Matt O'Riley,dk DEN,MF,Celtic,22,2000,5.4,14,8,7,6,1,9,19,47.4,10,8,1,7,7,21,10,0
511,Armando Obispo,nl NED,DF,PSV Eindhoven,24,1999,1.0,0,0,0,0,0,0,2,0.0,2,1,1,0,2,2,1,0
512,Jan Oblak,si SVN,GK,Atlético Madrid,30,1993,10.3,0,0,0,0,0,0,0,0.0,0,0,0,0,0,0,1,1
513,Lucas Ocampos,ar ARG,FW,Sevilla,29,1994,3.8,5,2,1,4,0,2,6,33.3,4,4,0,4,4,9,2,0
514,Álvaro Odriozola,es ESP,"DF,FW",Real Sociedad,27,1995,1.1,1,1,1,0,0,1,1,100.0,0,1,0,1,1,2,0,0
515,Noah Okafor,ch SUI,FW,Milan,23,2000,0.4,0,0,0,0,0,0,1,0.0,1,0,0,0,0,0,0,0
516,Olasagasti,es ESP,MF,Real Sociedad,22,2000,0.1,0,0,0,0,0,0,0,0.0,0,0,0,0,0,0,0,0
517,Peter Olayinka,ng NGA,"DF,FW",Red Star,27,1995,1.9,6,4,1,3,2,1,1,100.0,0,0,0,0,1,7,2,0
518,Sérgio Oliveira,pt POR,MF,Galatasaray,31,1992,1.4,4,3,1,2,1,1,4,25.0,3,5,0,5,0,4,2,1
520,Mathías Olivera,uy URU,DF,Napoli,25,1997,3.6,13,8,9,4,0,6,9,66.7,3,4,1,3,7,20,7,0
521,Dani Olmo,es ESP,MF,RB Leipzig,25,1998,2.0,4,1,2,2,0,1,4,25.0,3,1,0,1,0,4,2,0
522,André Onana,cm CMR,GK,Manchester Utd,27,1996,6.0,0,0,0,0,0,0,0,0.0,0,0,0,0,1,1,2,4
523,Loïs Openda,be BEL,FW,RB Leipzig,23,2000,6.1,2,1,1,1,0,0,7,0.0,7,3,0,3,0,2,2,0
524,Fredrik Oppegard,no NOR,FW,PSV Eindhoven,20,2002,0.0,1,1,1,0,0,1,1,100.0,0,0,0,0,1,2,0,0
525,Willi Orban,hu HUN,DF,RB Leipzig,30,1992,2.0,4,3,2,2,0,4,6,66.7,2,9,6,3,1,5,9,1
526,Stefan Ortega,de GER,GK,Manchester City,30,1992,3.0,0,0,0,0,0,0,0,0.0,0,0,0,0,0,0,1,0
527,Victor Osimhen,ng NGA,FW,Napoli,24,1998,5.1,0,0,0,0,0,0,1,0.0,1,2,2,0,3,3,10,0
528,Nicolás Otamendi,ar ARG,DF,Benfica,35,1988,6.0,12,4,9,3,0,9,18,50.0,9,11,6,5,11,23,24,1
529,Mikel Oyarzabal,es ESP,"FW,MF",Real Sociedad,26,1997,6.5,8,5,2,3,3,1,4,25.0,3,4,1,3,0,8,0,0
530,Salih Özcan,tr TUR,MF,Dortmund,25,1998,4.9,10,5,5,4,1,4,10,40.0,6,8,2,6,7,17,6,0
531,Jon Pacheco,es ESP,DF,Real Sociedad,22,2001,1.4,2,1,2,0,0,0,1,0.0,1,0,0,0,0,2,6,0
532,Igor Paixão,br BRA,FW,Feyenoord,23,2000,4.4,4,1,2,1,1,2,4,50.0,2,9,2,7,4,8,2,0
533,Thomas Partey,gh GHA,MF,Arsenal,30,1993,0.1,0,0,0,0,0,0,0,0.0,0,0,0,0,0,0,0,0
534,Patric,es ESP,DF,Lazio,30,1993,4.1,3,3,3,0,0,3,4,75.0,1,3,2,1,5,8,17,0
535,Benjamin Pavard,fr FRA,DF,Inter,27,1996,5.3,7,3,4,3,0,3,5,60.0,2,6,3,3,9,16,25,1
536,Aleksandar Pavlovic,de GER,MF,Bayern Munich,19,2004,2.3,1,0,0,1,0,0,3,0.0,3,5,2,3,3,4,5,0
537,Strahinja Pavlović,rs SRB,DF,RB Salzburg,22,2001,5.5,12,6,7,5,0,7,12,58.3,5,7,4,3,5,17,26,1
538,Nicolás Paz,ar ARG,MF,Real Madrid,18,2004,0.5,2,2,1,1,0,1,2,50.0,1,4,0,4,0,2,1,0
539,Pedri,es ESP,"MF,FW",Barcelona,20,2002,3.7,10,8,3,4,3,6,13,46.2,7,5,1,4,2,12,10,0
540,Pedro,es ESP,FW,Lazio,36,1987,2.1,2,1,0,2,0,0,2,0.0,2,1,1,0,0,2,1,0
541,Adrià Pedrosa,es ESP,"DF,FW",Sevilla,25,1998,3.6,6,6,3,3,0,4,11,36.4,7,1,1,0,2,8,4,0
542,Luca Pellegrini,it ITA,DF,Lazio,24,1999,1.8,2,1,1,1,0,1,3,33.3,2,4,1,3,3,5,5,0
543,Facundo Pellistri,uy URU,FW,Manchester Utd,21,2001,1.2,3,2,1,1,1,0,2,0.0,2,0,0,0,1,4,0,0
544,Iñaki Peña,es ESP,GK,Barcelona,24,1999,2.0,0,0,0,0,0,0,0,0.0,0,0,0,0,0,0,2,0
546,Pepe,pt POR,DF,Porto,40,1983,7.3,10,8,9,1,0,6,11,54.5,5,6,5,1,8,18,20,0
547,Pepê,br BRA,"MF,FW",Porto,26,1997,7.1,10,7,8,2,0,1,6,16.7,5,3,0,3,3,13,1,1
548,Ricardo Pepi,us USA,"FW,MF",PSV Eindhoven,20,2003,1.5,1,0,0,1,0,0,0,0.0,0,1,0,1,0,1,0,0
549,Danilo Pereira,pt POR,DF,Paris S-G,31,1991,1.8,4,4,3,1,0,1,1,100.0,0,2,2,0,1,5,3,0
550,Noah Persson,se SWE,"DF,MF",Young Boys,20,2003,0.4,0,0,0,0,0,0,2,0.0,2,0,0,0,0,0,2,0
551,Kalvin Phillips,eng ENG,MF,Manchester City,27,1995,1.4,2,2,2,0,0,0,1,0.0,1,0,0,0,0,2,1,0
552,Nathaniel Phillips,eng ENG,DF,Celtic,26,1997,1.0,0,0,0,0,0,0,0,0.0,0,2,1,1,2,2,3,0
553,Kamil Piątkowski,pl POL,DF,RB Salzburg,23,2000,2.0,5,4,3,2,0,3,4,75.0,1,2,0,2,4,9,14,0
554,Pizzi,pt POR,MF,Braga,33,1989,0.6,0,0,0,0,0,0,0,0.0,0,0,0,0,0,0,0,0
555,Tommaso Pobega,it ITA,MF,Milan,24,1999,1.7,3,1,2,1,0,2,4,50.0,2,2,1,1,1,4,3,0
556,Matteo Politano,it ITA,FW,Napoli,29,1993,6.4,3,1,2,1,0,2,12,16.7,10,2,0,2,1,4,2,0
557,Nick Pope,eng ENG,GK,Newcastle Utd,31,1992,5.0,0,0,0,0,0,0,0,0.0,0,0,0,0,0,0,2,0
558,Yussuf Poulsen,dk DEN,"FW,MF",RB Leipzig,29,1994,3.7,1,0,0,0,1,0,4,0.0,4,2,0,2,1,2,0,1
559,Ivan Provedel,it ITA,GK,Lazio,29,1994,8.0,0,0,0,0,0,0,0,0.0,0,0,0,0,0,0,1,0
560,Christian Pulisic,us USA,FW,Milan,24,1998,4.9,6,4,1,4,1,2,2,100.0,0,7,1,6,0,6,2,0
561,Anthony Racioppi,ch SUI,GK,Young Boys,24,1998,5.0,0,0,0,0,0,0,0,0.0,0,0,0,0,0,0,2,2
562,Ivan Rakitić,hr CRO,MF,Sevilla,35,1988,5.1,11,4,2,9,0,3,10,30.0,7,6,2,4,3,14,3,0
563,Yaroslav Rakitskiy,ua UKR,DF,Shakhtar,33,1989,3.8,3,2,3,0,0,2,4,50.0,2,6,4,2,6,9,22,0
564,André Ramalho,br BRA,DF,PSV Eindhoven,31,1992,4.7,8,5,5,3,0,5,5,100.0,0,10,6,4,4,12,15,0
565,Gonçalo Ramos,pt POR,FW,Paris S-G,22,2001,2.4,4,3,2,2,0,2,4,50.0,2,1,0,1,0,4,2,0
566,Sergio Ramos,es ESP,DF,Sevilla,37,1986,5.0,2,2,1,1,0,2,4,50.0,2,12,9,3,4,6,16,0
567,Aaron Ramsdale,eng ENG,GK,Arsenal,25,1998,1.0,0,0,0,0,0,0,0,0.0,0,0,0,0,0,0,0,0
568,Raphinha,br BRA,FW,Barcelona,26,1996,5.2,8,6,6,2,0,4,7,57.1,3,6,0,6,1,9,2,0
569,Marcus Rashford,eng ENG,FW,Manchester Utd,25,1997,3.2,3,3,1,2,0,1,3,33.3,2,2,0,2,1,4,2,0
570,Giacomo Raspadori,it ITA,"FW,MF",Napoli,23,2000,2.8,3,0,0,3,0,1,3,33.3,2,2,0,2,1,4,2,0
572,Petar Ratkov,rs SRB,FW,RB Salzburg,19,2003,2.4,1,0,0,1,0,1,1,100.0,0,2,0,2,0,1,3,0
573,David Raum,de GER,DF,RB Leipzig,25,1998,7.0,17,12,8,5,4,11,17,64.7,6,11,7,4,10,27,15,0
574,David Raya,es ESP,GK,Arsenal,27,1995,9.3,0,0,0,0,0,0,0,0.0,0,0,0,0,0,0,4,1
575,Sergio Reguilón,es ESP,DF,Manchester Utd,26,1996,1.7,2,0,2,0,0,0,5,0.0,5,3,0,3,3,5,2,0
576,Tijjani Reijnders,nl NED,MF,Milan,25,1998,5.3,11,4,4,5,2,6,11,54.5,5,7,0,7,5,16,4,0
577,Álex Remiro,es ESP,GK,Real Sociedad,28,1995,8.0,0,0,0,0,0,0,0,0.0,0,0,0,0,0,0,3,0
578,Marco Reus,de GER,"MF,FW",Dortmund,34,1989,5.4,12,4,7,2,3,5,12,41.7,7,8,3,5,3,15,8,0
579,Gio Reyna,us USA,"FW,MF",Dortmund,20,2002,0.2,1,0,0,1,0,1,1,100.0,0,1,1,0,0,1,1,0
580,Declan Rice,eng ENG,MF,Arsenal,24,1999,9.3,14,10,2,9,3,9,16,56.3,7,11,7,4,13,27,15,0
581,Rodrigo Riquelme,es ESP,DF,Atlético Madrid,23,2000,3.5,10,6,8,1,1,9,21,42.9,12,3,0,3,2,12,4,0
582,Dmytro Riznyk,ua UKR,GK,Shakhtar,24,1999,6.0,1,1,1,0,0,1,1,100.0,0,0,0,0,0,1,3,1
583,Sergi Roberto,es ESP,MF,Barcelona,31,1992,2.3,3,3,1,1,1,1,6,16.7,5,2,0,2,1,4,2,0
584,Milan Rodić,rs SRB,DF,Red Star,32,1991,4.6,9,5,6,2,1,6,10,60.0,4,7,4,3,4,13,13,0
585,Rodri,es ESP,MF,Manchester City,27,1996,7.7,14,11,6,7,1,9,13,69.2,4,2,0,2,6,20,6,1
586,Rodrygo,br BRA,FW,Real Madrid,22,2001,11.2,8,5,3,2,3,2,12,16.7,10,13,1,12,2,10,2,0
587,Alessio Romagnoli,it ITA,DF,Lazio,28,1995,6.0,7,4,4,3,0,4,5,80.0,1,7,5,2,2,9,21,0
588,Oriol Romeu,es ESP,MF,Barcelona,31,1991,3.8,7,4,2,4,1,3,8,37.5,5,5,1,4,1,8,1,3
589,Jérôme Roussillon,fr FRA,DF,Union Berlin,30,1993,2.9,8,5,3,4,1,3,4,75.0,1,3,3,0,0,8,10,0
590,Nicolò Rovella,it ITA,MF,Lazio,21,2001,1.5,5,4,2,2,1,2,4,50.0,2,1,0,1,3,8,0,0
591,Amir Rrahmani,xk KVX,DF,Napoli,29,1994,6.1,5,3,2,1,2,2,4,50.0,2,4,1,3,11,16,33,0
592,Donat Rrudhani,xk KVX,MF,Young Boys,24,1999,0.1,0,0,0,0,0,0,0,0.0,0,1,0,1,0,0,0,0
593,Antonio Rüdiger,de GER,DF,Real Madrid,30,1993,11.6,11,6,9,2,0,7,9,77.8,2,21,19,2,4,15,35,0
594,Mário Rui,pt POR,DF,Napoli,32,1991,2.4,3,1,1,2,0,3,10,30.0,7,3,0,3,2,5,5,0
595,Abel Ruiz,es ESP,"FW,MF",Braga,23,2000,2.4,1,0,0,0,1,0,0,0.0,0,1,0,1,0,1,0,0
596,Fabián Ruiz Peña,es ESP,MF,Paris S-G,27,1996,6.9,14,8,7,6,1,8,14,57.1,6,10,0,10,7,21,4,0
598,Julian Ryerson,no NOR,DF,Dortmund,25,1997,10.0,27,17,17,10,0,14,38,36.8,24,14,5,9,4,31,18,0
599,Frederik Rønnow,dk DEN,GK,Union Berlin,30,1992,6.0,0,0,0,0,0,0,0,0.0,0,0,0,0,0,0,2,0
600,Serdar Saatçı,tr TUR,DF,Braga,20,2003,3.6,7,2,6,1,0,3,5,60.0,2,5,1,4,5,12,8,0
601,Marcel Sabitzer,at AUT,MF,Dortmund,29,1994,10.3,12,7,6,4,2,8,14,57.1,6,9,3,6,7,19,22,0
602,Umar Sadiq,ng NGA,FW,Real Sociedad,26,1997,1.1,2,1,0,2,0,0,0,0.0,0,0,0,0,0,2,1,0
603,Ismael Saibari,ma MAR,MF,PSV Eindhoven,22,2001,3.5,4,3,2,2,0,2,6,33.3,4,2,0,2,3,7,3,0
604,Wesley Saïd,fr FRA,"FW,MF",Lens,28,1995,0.6,1,0,0,1,0,1,2,50.0,1,0,0,0,0,1,0,0
605,Bukayo Saka,eng ENG,FW,Arsenal,21,2001,8.0,16,12,3,8,5,6,15,40.0,9,10,1,9,2,18,3,0
606,Kike Salas,es ESP,DF,Sevilla,21,2002,1.8,4,2,1,3,0,2,2,100.0,0,2,0,2,5,9,7,0
607,William Saliba,fr FRA,DF,Arsenal,22,2001,10.0,10,4,4,4,2,5,9,55.6,4,8,3,5,7,17,26,0
608,Brice Samba,fr FRA,GK,Lens,29,1994,6.0,0,0,0,0,0,0,0,0.0,0,1,0,1,0,0,1,1
609,Alexis Sánchez,cl CHI,FW,Inter,34,1988,3.7,5,4,1,4,0,3,5,60.0,2,0,0,0,2,7,0,0
610,Davinson Sánchez,co COL,DF,Galatasaray,27,1996,4.0,8,7,4,2,2,5,12,41.7,7,9,3,6,5,13,12,1
611,Juanlu Sánchez,es ESP,DF,Sevilla,19,2003,3.6,15,8,10,4,1,9,24,37.5,15,6,1,5,2,17,5,0
612,Jadon Sancho,eng ENG,FW,Dortmund,23,2000,6.2,9,7,2,5,2,4,6,66.7,2,10,0,10,2,11,2,0
613,Leroy Sané,de GER,FW,Bayern Munich,27,1996,10.2,13,9,3,4,6,3,13,23.1,10,7,0,7,2,15,1,0
614,Zaidu Sanusi,ng NGA,DF,Porto,26,1997,3.4,7,4,5,2,0,3,5,60.0,2,2,0,2,4,11,6,0
615,Bouna Sarr,sn SEN,DF,Bayern Munich,31,1992,0.1,0,0,0,0,0,0,0,0.0,0,0,0,0,1,1,0,0
616,Leo Sauer,sk SVK,"MF,FW",Feyenoord,17,2005,0.2,0,0,0,0,0,0,1,0.0,1,1,0,1,0,0,0,0
617,Stefan Savić,me MNE,DF,Atlético Madrid,32,1991,4.6,5,2,3,1,1,3,3,100.0,0,4,1,3,11,16,15,0
618,Liam Scales,ie IRL,DF,Celtic,24,1998,6.0,8,5,7,1,0,6,8,75.0,2,8,7,1,0,8,29,0
619,Fabian Schär,ch SUI,DF,Newcastle Utd,31,1991,6.0,7,7,4,3,0,4,9,44.4,5,7,5,2,6,13,28,0
620,Alexander Schlager,at AUT,GK,RB Salzburg,27,1996,6.0,0,0,0,0,0,0,0,0.0,0,0,0,0,1,1,2,0
621,Xaver Schlager,at AUT,MF,RB Leipzig,25,1997,6.9,21,15,10,10,1,4,13,30.8,9,9,3,6,5,26,7,2
622,Nico Schlotterbeck,de GER,DF,Dortmund,23,1999,10.8,26,15,17,9,0,18,21,85.7,3,20,12,8,11,37,38,1
624,Jerdy Schouten,nl NED,"MF,DF",PSV Eindhoven,26,1997,6.9,13,9,4,6,3,6,9,66.7,3,6,2,4,5,18,7,0
625,Nicolas Seiwald,at AUT,MF,RB Leipzig,22,2001,3.0,9,5,3,5,1,4,8,50.0,4,5,1,4,5,14,4,0
626,Benjamin Šeško,si SVN,FW,RB Leipzig,20,2003,4.5,4,1,0,2,2,3,10,30.0,7,5,0,5,1,5,3,0
627,Luke Shaw,eng ENG,DF,Manchester Utd,28,1995,1.5,2,2,0,2,0,1,2,50.0,1,2,1,1,3,5,0,0
628,Maryan Shved,ua UKR,FW,Shakhtar,26,1997,0.1,0,0,0,0,0,0,0,0.0,0,0,0,0,0,0,0,0
629,Danylo Sikan,ua UKR,FW,Shakhtar,22,2001,5.3,6,5,2,3,1,2,5,40.0,3,7,1,6,1,7,11,1
630,André Silva,pt POR,FW,Real Sociedad,27,1995,1.0,2,1,2,0,0,1,1,100.0,0,1,1,0,0,2,1,0
631,António Silva,pt POR,DF,Benfica,19,2003,3.1,8,6,7,1,0,6,7,85.7,1,3,2,1,1,9,16,0
632,Bernardo Silva,pt POR,"FW,MF",Manchester City,28,1994,5.9,11,6,4,4,3,6,13,46.2,7,6,1,5,2,13,6,0
633,Rafa Silva,pt POR,"MF,FW",Benfica,30,1993,5.6,7,4,2,2,3,1,6,16.7,5,2,0,2,3,10,0,0
634,Mohamed Simakan,fr FRA,DF,RB Leipzig,23,2000,6.6,12,7,12,0,0,7,15,46.7,8,7,4,3,10,22,23,0
635,Giovanni Simeone,ar ARG,FW,Napoli,28,1995,1.1,3,2,2,1,0,0,0,0.0,0,0,0,0,1,4,1,0
636,Roko Simic,hr CRO,FW,RB Salzburg,19,2003,3.8,2,1,1,1,0,1,1,100.0,0,1,0,1,2,4,3,0
637,Xavi Simons,nl NED,"MF,FW",RB Leipzig,20,2003,6.6,5,2,3,2,0,1,7,14.3,6,7,0,7,4,9,1,0
638,Leo Skiri Østigård,no NOR,DF,Napoli,23,1999,2.1,4,3,3,1,0,0,1,0.0,1,4,3,1,2,6,13,0
639,Milan Škriniar,sk SVK,DF,Paris S-G,28,1995,6.0,12,7,9,3,0,8,8,100.0,0,5,3,2,5,17,12,0
640,Emile Smith Rowe,eng ENG,MF,Arsenal,23,2000,0.5,1,1,1,0,0,1,2,50.0,1,0,0,0,1,2,0,0
641,Cédric Soares,pt POR,DF,Arsenal,31,1991,0.7,0,0,0,0,0,0,2,0.0,2,2,0,2,0,0,2,0
642,Carlos Soler,es ESP,"MF,FW",Paris S-G,26,1997,0.1,0,0,0,0,0,0,0,0.0,0,0,0,0,0,0,0,0
643,Oumar Solet,fr FRA,DF,RB Salzburg,23,2000,1.7,3,3,3,0,0,2,3,66.7,1,2,1,1,2,5,4,0
644,Yann Sommer,ch SUI,GK,Inter,34,1988,7.3,0,0,0,0,0,0,0,0.0,0,0,0,0,0,0,2,0
645,Florian Sotoca,fr FRA,MF,Lens,32,1990,5.2,10,7,6,3,1,7,12,58.3,5,7,1,6,5,15,8,0
646,Boubakary Soumaré,fr FRA,MF,Sevilla,24,1999,2.4,5,5,2,3,0,2,3,66.7,1,3,1,2,3,8,2,0
647,Djibril Sow,ch SUI,MF,Sevilla,26,1997,4.1,5,3,2,3,0,1,3,33.3,2,3,1,2,1,6,3,0
648,Çağlar Söyüncü,tr TUR,DF,Atlético Madrid,27,1996,0.7,0,0,0,0,0,0,0,0.0,0,0,0,0,0,0,1,0
650,Uroš Spajić,rs SRB,DF,Red Star,30,1993,0.7,0,0,0,0,0,0,1,0.0,1,1,1,0,0,0,0,0
651,Marco Sportiello,it ITA,GK,Milan,31,1992,0.1,0,0,0,0,0,0,0,0.0,0,0,0,0,0,0,1,0
652,Marko Stamenic,nz NZL,MF,Red Star,21,2002,3.3,5,1,3,0,2,4,10,40.0,6,8,3,5,2,7,11,0
653,Orri Steinn Óskarsson,is ISL,FW,FC Copenhagen,18,2004,1.6,2,0,1,1,0,1,1,100.0,0,1,0,1,0,2,0,0
654,Calvin Stengs,nl NED,"FW,MF",Feyenoord,24,1998,5.2,8,7,1,5,2,2,6,33.3,4,2,1,1,2,10,1,0
655,Taras Stepanenko,ua UKR,MF,Shakhtar,33,1989,5.5,14,7,12,2,0,8,9,88.9,1,5,2,3,6,20,19,0
656,John Stones,eng ENG,"DF,MF",Manchester City,29,1994,3.8,2,1,1,1,0,0,0,0.0,0,4,2,2,2,4,7,0
657,Luka Sučić,hr CRO,"FW,MF",RB Salzburg,20,2002,4.4,6,5,2,4,0,3,9,33.3,6,9,0,9,5,11,7,0
658,Heorhiy Sudakov,ua UKR,MF,Shakhtar,20,2002,6.0,4,2,2,2,0,2,8,25.0,6,3,0,3,6,10,6,0
659,Niklas Süle,de GER,DF,Dortmund,27,1995,4.4,12,9,9,3,0,10,18,55.6,8,4,2,2,2,14,14,0
660,Suso,es ESP,MF,Sevilla,29,1993,0.9,1,1,1,0,0,1,4,25.0,3,0,0,0,0,1,0,0
661,Mahamadou Susoho,es ESP,MF,Manchester City,18,2005,0.2,0,0,0,0,0,0,0,0.0,0,0,0,0,0,0,0,0
662,Christian Sørensen,dk DEN,DF,FC Copenhagen,30,1992,0.5,0,0,0,0,0,0,3,0.0,3,1,0,1,0,0,1,0
663,Mehdi Taremi,ir IRN,FW,Porto,31,1992,6.1,17,8,3,8,6,3,9,33.3,6,10,0,10,0,17,8,0
664,Matt Targett,eng ENG,DF,Newcastle Utd,27,1995,0.2,0,0,0,0,0,0,0,0.0,0,0,0,0,0,0,0,0
665,Greg Taylor,sct SCO,DF,Celtic,25,1997,6.0,11,8,6,5,0,7,11,63.6,4,6,2,4,4,15,12,0
666,Aurélien Tchouaméni,fr FRA,"MF,DF",Real Madrid,23,2000,6.7,9,4,6,3,0,2,8,25.0,6,9,6,3,9,18,12,0
667,Mathys Tel,fr FRA,"FW,MF",Bayern Munich,18,2005,1.6,1,1,0,1,0,1,4,25.0,3,4,0,4,2,3,0,0
668,Casper Tengstedt,dk DEN,FW,Benfica,23,2000,1.5,1,0,0,1,0,1,1,100.0,0,1,0,1,0,1,0,0
669,Marc-André ter Stegen,de GER,GK,Barcelona,31,1992,8.0,0,0,0,0,0,0,0,0.0,0,0,0,0,0,0,1,0
670,Aleksa Terzić,rs SRB,DF,RB Salzburg,23,1999,2.0,3,1,2,1,0,2,6,33.3,4,0,0,0,2,5,3,0
671,Tetê,br BRA,FW,Galatasaray,23,2000,2.5,7,2,3,2,2,4,10,40.0,6,2,0,2,2,9,3,0
672,Jordan Teze,nl NED,DF,PSV Eindhoven,23,1999,8.0,15,9,11,4,0,8,15,53.3,7,8,4,4,7,22,8,0
673,Odin Thiago Holm,no NOR,MF,Celtic,20,2003,0.6,0,0,0,0,0,0,1,0.0,1,1,0,1,0,0,2,0
674,Malick Thiaw,de GER,DF,Milan,21,2001,4.1,8,3,4,4,0,3,4,75.0,1,7,4,3,4,12,19,0
676,Adrien Thomasson,fr FRA,MF,Lens,29,1993,2.5,0,0,0,0,0,0,1,0.0,1,5,0,5,0,0,2,1
677,Marcus Thuram,fr FRA,FW,Inter,25,1997,5.1,4,3,1,1,2,1,1,100.0,0,2,0,2,1,5,3,0
678,Cheikh Tidiane Niasse,sn SEN,MF,Young Boys,23,2000,5.9,6,5,1,2,3,1,7,14.3,6,15,6,9,17,23,4,0
679,Kieran Tierney,sct SCO,DF,Real Sociedad,26,1997,0.7,2,2,0,1,1,2,2,100.0,0,3,0,3,2,4,2,0
680,Guus Til,nl NED,MF,PSV Eindhoven,25,1997,2.0,2,2,2,0,0,1,2,50.0,1,3,0,3,0,2,1,0
681,Malik Tillman,us USA,MF,PSV Eindhoven,21,2002,5.6,13,11,0,10,3,2,4,50.0,2,13,2,11,8,21,5,0
682,Quinten Timber,nl NED,MF,Feyenoord,22,2001,5.1,6,5,0,5,1,2,4,50.0,2,9,0,9,3,9,1,0
683,Takehiro Tomiyasu,jp JPN,DF,Arsenal,24,1998,4.3,4,3,2,0,2,3,6,50.0,3,4,0,4,2,6,5,0
684,Fikayo Tomori,eng ENG,DF,Milan,25,1997,6.0,16,9,7,8,1,6,7,85.7,1,13,6,7,10,26,15,0
685,Sandro Tonali,it ITA,MF,Newcastle Utd,23,2000,1.8,1,1,1,0,0,1,1,100.0,0,1,0,1,2,3,2,0
686,Lucas Torreira,uy URU,MF,Galatasaray,27,1996,5.5,11,7,5,6,0,2,7,28.6,5,6,0,6,8,19,10,1
687,Ferrán Torres,es ESP,FW,Barcelona,23,2000,4.2,4,3,2,1,1,1,2,50.0,1,2,0,2,0,4,3,0
688,Óliver Torres,es ESP,"FW,MF",Sevilla,28,1994,1.1,1,0,0,1,0,1,1,100.0,0,2,0,2,0,1,0,0
689,Lucas Tousart,fr FRA,MF,Union Berlin,26,1997,2.6,10,5,9,1,0,5,7,71.4,2,3,0,3,4,14,4,0
690,Chaka Traorè,ci CIV,MF,Milan,18,2004,0.2,0,0,0,0,0,0,1,0.0,1,0,0,0,0,0,0,0
691,Hamari Traoré,ml MLI,DF,Real Sociedad,31,1992,5.9,7,3,2,2,3,3,7,42.9,4,6,2,4,12,19,11,0
692,Gernot Trauner,at AUT,DF,Feyenoord,31,1992,3.1,5,3,3,2,0,2,3,66.7,1,6,4,2,2,7,8,0
693,Christopher Trimmel,at AUT,"FW,DF",Union Berlin,36,1987,1.4,4,4,2,2,0,3,4,75.0,1,2,0,2,1,5,3,0
694,Kieran Trippier,eng ENG,DF,Newcastle Utd,32,1990,5.7,11,6,7,3,1,7,16,43.8,9,8,2,6,5,16,13,0
695,Leandro Trossard,be BEL,FW,Arsenal,28,1994,5.9,4,1,1,1,2,2,9,22.2,7,4,0,4,3,7,5,0
696,Anatolii Trubin,ua UKR,GK,Benfica,21,2001,6.0,0,0,0,0,0,0,1,0.0,1,0,0,0,0,0,2,0
697,David Turnbull,sct SCO,"MF,FW",Celtic,24,1999,0.4,1,0,1,0,0,1,3,33.3,2,1,0,1,0,1,1,0
698,Beñat Turrientes,es ESP,MF,Real Sociedad,21,2002,2.1,4,3,1,2,1,0,4,0.0,4,4,2,2,1,5,1,1
699,Ayase Ueda,jp JPN,FW,Feyenoord,24,1998,1.7,1,1,0,0,1,0,0,0.0,0,0,0,0,0,1,0,0
700,Manuel Ugarte Ribeiro,uy URU,MF,Paris S-G,22,2001,4.3,8,3,3,4,1,4,22,18.2,18,2,1,1,8,16,5,0
702,Filip Ugrinic,ch SUI,MF,Young Boys,24,1999,5.7,14,9,7,4,3,3,12,25.0,9,16,3,13,5,19,3,0
703,Andreas Ulmer,at AUT,DF,RB Salzburg,37,1985,2.4,7,5,4,1,2,3,4,75.0,1,6,2,4,1,8,5,0
704,Sven Ulreich,de GER,GK,Bayern Munich,34,1988,3.0,0,0,0,0,0,0,0,0.0,0,0,0,0,0,0,2,1
705,Dayot Upamecano,fr FRA,DF,Bayern Munich,24,1998,5.5,16,11,11,5,0,7,9,77.8,2,2,1,1,5,21,13,0
706,Anthony Valencia,ec ECU,"MF,FW",Antwerp,20,2003,0.4,0,0,0,0,0,0,0,0.0,0,0,0,0,0,0,0,0
707,Federico Valverde,uy URU,"MF,FW",Real Madrid,25,1998,11.9,21,13,12,6,3,10,20,50.0,10,13,4,9,13,34,18,0
708,Zeno Van den Bosch,be BEL,DF,Antwerp,20,2003,1.0,1,0,1,0,0,0,0,0.0,0,2,0,2,1,2,5,0
709,Raphaël Varane,fr FRA,DF,Manchester Utd,30,1993,3.7,4,3,2,2,0,1,1,100.0,0,6,3,3,4,8,13,0
710,Alan Varela,ar ARG,MF,Porto,22,2001,7.8,15,6,6,8,1,6,11,54.5,5,5,1,4,8,23,12,1
711,Denis Vavro,sk SVK,DF,FC Copenhagen,27,1996,7.9,6,2,5,1,0,5,10,50.0,5,14,12,2,6,12,53,0
712,Lucas Vázquez,es ESP,DF,Real Madrid,32,1991,4.2,5,5,2,3,0,1,6,16.7,5,2,0,2,1,6,3,0
713,Matías Vecino,uy URU,MF,Lazio,31,1991,5.2,9,5,3,4,2,5,18,27.8,13,8,3,5,6,15,13,0
714,Joey Veerman,nl NED,MF,PSV Eindhoven,24,1998,6.4,13,7,5,6,2,7,20,35.0,13,8,0,8,6,19,11,0
715,Arthur Vermeeren,be BEL,MF,Antwerp,18,2005,6.0,19,8,8,9,2,10,16,62.5,6,13,4,9,7,26,6,1
716,Yorbe Vertessen,be BEL,FW,PSV Eindhoven,22,2001,1.8,1,1,1,0,0,0,1,0.0,1,1,0,1,0,1,0,0
717,Fabio Vieira,pt POR,FW,Arsenal,23,2000,1.0,0,0,0,0,0,0,0,0.0,0,0,0,0,0,0,1,0
718,Vitinha,pt POR,MF,Paris S-G,23,2000,10.2,15,11,5,8,2,3,12,25.0,9,8,0,8,13,28,14,0
719,Kevin Volland,de GER,"FW,MF",Union Berlin,31,1992,2.6,5,3,1,3,1,0,4,0.0,4,3,0,3,0,5,0,1
720,Stefan de Vrij,nl NED,DF,Inter,31,1992,5.5,9,5,6,3,0,4,8,50.0,4,6,3,3,5,14,34,0
721,Elye Wahi,fr FRA,FW,Lens,20,2003,5.1,2,2,0,1,1,0,0,0.0,0,0,0,0,0,2,0,0
722,Kyle Walker,eng ENG,DF,Manchester City,33,1990,5.6,7,3,2,4,1,6,7,85.7,1,1,0,1,4,11,4,0
723,Aaron Wan-Bissaka,eng ENG,DF,Manchester Utd,25,1997,2.4,7,5,3,4,0,1,1,100.0,0,1,0,1,10,17,9,0
724,Timon Wellenreuther,de GER,GK,Feyenoord,27,1995,2.0,0,0,0,0,0,0,0,0.0,0,0,0,0,0,0,0,0
725,Stephen Welsh,sct SCO,DF,Celtic,23,2000,0.8,3,1,2,1,0,1,1,100.0,0,1,1,0,0,3,3,0
726,Wendell,br BRA,DF,Porto,30,1993,4.3,16,7,12,4,0,4,8,50.0,4,5,2,3,9,25,10,0
728,Timo Werner,de GER,"FW,MF",RB Leipzig,27,1996,0.6,1,1,1,0,0,1,1,100.0,0,1,0,1,0,1,1,0
729,Ben White,eng ENG,DF,Arsenal,25,1997,8.4,9,5,1,5,3,5,15,33.3,10,10,1,9,9,18,10,0
730,Mats Wieffer,nl NED,MF,Feyenoord,23,1999,5.2,9,5,3,4,2,6,9,66.7,3,5,0,5,10,19,5,0
731,Owen Wijndal,nl NED,DF,Antwerp,23,1999,5.0,13,6,9,3,1,6,14,42.9,8,9,3,6,3,16,10,0
732,Joe Willock,eng ENG,MF,Newcastle Utd,23,1999,1.1,2,2,1,1,0,2,3,66.7,1,1,1,0,0,2,0,0
733,Callum Wilson,eng ENG,FW,Newcastle Utd,31,1992,2.7,0,0,0,0,0,0,1,0.0,1,1,0,1,0,0,0,0
734,Axel Witsel,be BEL,"DF,MF",Atlético Madrid,34,1989,9.8,7,4,4,2,1,3,4,75.0,1,15,8,7,11,18,26,0
735,Marius Wolf,de GER,"DF,FW",Dortmund,28,1995,3.2,13,8,9,2,2,6,8,75.0,2,4,1,3,4,17,14,0
736,Jacob Wright,eng ENG,FW,Manchester City,17,2005,0.0,0,0,0,0,0,0,0,0.0,0,0,0,0,0,0,0,0
737,Lamine Yamal,es ESP,FW,Barcelona,16,2007,6.4,9,7,2,3,4,1,11,9.1,10,15,0,15,7,16,1,0
738,Alhassan Yusuf,ng NGA,MF,Antwerp,23,2000,4.2,9,6,1,6,2,4,11,36.4,7,8,4,4,3,12,5,1
739,Mattia Zaccagni,it ITA,FW,Lazio,28,1995,5.1,8,5,2,6,0,4,7,57.1,3,8,1,7,5,13,2,0
740,Wilfried Zaha,ci CIV,FW,Galatasaray,30,1992,4.4,9,7,2,6,1,3,4,75.0,1,5,0,5,1,10,1,0
741,Warren Zaïre-Emery,fr FRA,MF,Paris S-G,17,2006,10.0,15,8,5,6,4,6,16,37.5,10,14,1,13,7,22,10,0
742,Arsen Zakharyan,ru RUS,"FW,MF",Real Sociedad,20,2003,2.4,4,1,2,2,0,1,1,100.0,0,7,0,7,1,5,1,0
743,Rodrigo Zalazar,uy URU,MF,Braga,23,1999,4.4,18,9,9,8,1,11,18,61.1,7,7,1,6,2,20,2,0
744,Andre-Frank Zambo Anguissa,cm CMR,MF,Napoli,27,1995,7.0,11,6,3,8,0,5,17,29.4,12,11,1,10,8,19,9,0
745,Alessandro Zanoli,it ITA,DF,Napoli,22,2000,0.0,0,0,0,0,0,0,0,0.0,0,0,0,0,0,0,1,0
746,Ramiz Zerrouki,dz ALG,MF,Feyenoord,25,1998,3.9,10,6,6,3,1,6,8,75.0,2,5,1,4,5,15,3,0
747,Piotr Zieliński,pl POL,MF,Napoli,29,1994,5.2,2,1,0,1,1,0,2,0.0,2,1,0,1,4,6,2,0
748,Oleksandr Zinchenko,ua UKR,DF,Arsenal,26,1996,3.1,6,3,5,1,0,4,8,50.0,4,3,0,3,4,10,2,0
749,Hakim Ziyech,ma MAR,FW,Galatasaray,30,1993,2.8,4,2,1,1,2,2,6,33.3,4,6,2,4,4,8,0,0
750,Igor Zubeldia,es ESP,DF,Real Sociedad,26,1997,7.7,14,12,9,4,1,8,9,88.9,1,12,7,5,8,22,23,0
751,Martín Zubimendi,es ESP,MF,Real Sociedad,24,1999,7.9,18,7,5,12,1,5,10,50.0,5,9,1,8,7,25,12,0
752,Oleksandr Zubkov,ua UKR,"FW,MF",Shakhtar,26,1996,5.9,11,6,5,4,2,7,14,50.0,7,2,0,2,2,13,7,0
754,Martin Ødegaard,no NOR,MF,Arsenal,24,1998,8.3,11,5,2,7,2,4,11,36.4,7,6,0,6,7,18,0,0
755,Łukasz Łakomy,pl POL,MF,Young Boys,22,2001,0.2,1,1,0,1,0,1,1,100.0,0,0,0,0,0,1,0,0
